new_para	doc
ADJ_AAKKOSELLINEN	nen stem, nen : se variation, back harmony
ADJ_AAVA	a stems, a : o : empi variations
ADJ_ABNORMAALI	i stem, i : e
ADJ_ABNORMI	i stem, i : e variations, back harmony
ADJ_AHNE	e stem, e : ee variation
ADJ_AIEMPI	mpi stem, mpi : mma lexicalised comparatives
ADJ_AINOA	a stem, a : 0 variation, colloquial a : o chance
ADJ_AINUT	defective paradigm for ainut
ADJ_ALASTON	ton stem, ton : toma variations
ADJ_AUTIO	o stem no variations
ADJ_AUTUAS	as stem, as : aa variations
ADJ_AVOIN	n stem, n : me variations
ADJ_BEIGE	e stem, no variations, front harmony
ADJ_CHIC	consonant stems, X : Xe variations, front harmony
ADJ_COOL	consonant stems, X : Xe variations, back harmony
ADJ_EHTA	ta stem, ta : da  variations
ADJ_EHYT	yt stem, yt : ye variations
ADJ_ENSIMMÄINEN	nen stem, nen : se variations, front harmony, ordinals
ADJ_GAY	y stems, no variations, loan word stuff
ADJ_HAILAKKA	kka stem, kka : ko variations
ADJ_HALPA	pa stem, pa : va : vempi variations
ADJ_HAPAN	‘hapan’, pan : ppama variations
ADJ_HAPERA	a stem, a : o ~ 0 variations
ADJ_HARMAJA	a stem, a : 0 variations, archaic aa : ata variations
ADJ_HARRAS	rras stem, rras : rtaa variations
ADJ_HELLE	lle stem, lle : ltee variations
ADJ_HIDAS	das stem, das : taa variations
ADJ_HOIKKA	kka stems, kka : k variations
ADJ_HUPAKKO	kko stems, kko : ko variations
ADJ_HURTTI	tti stems, tti : te variations
ADJ_HÄPÄISTY	y stems, no variations
ADJ_HÖLÖ	ö stems, no variations
ADJ_HÖMPPÄ	ppä stems, ppä : p variations
ADJ_HÖPPÄNÄ	ä stem,  ä : ö : 0 variations
ADJ_IKÄLOPPU	ppu stem, ppu : pu variations
ADJ_JÄREÄ	eä stem, ä : 0 variation
ADJ_KADE	de stem, de : tee variation
ADJ_KELPO	po stem, po : vo variations
ADJ_KOHELO	o stem, no variations
ADJ_KOLKKO	ko stem, kko : ko variations
ADJ_KOLMAS	s stem, s:nne variation, back harmony, ordinals
ADJ_KORKEA	ea stem, ea : e variations
ADJ_KULTA	lta stem, lta : lla variations
ADJ_KULUNUT	ut stem, ut : ee variations
ADJ_KYLMÄJÄRKINEN	nen stem, nen : se variations, front harmony
ADJ_KYMMENTÄ	bound numeral multiplier
ADJ_KYVYTÖN	tön stem, tön : ttömä variation, usually derived
ADJ_KYYTTÖ	ttö stems, ttö : tö variations
ADJ_KÄYPÄ	pä stems, pä : v variations
ADJ_KÖKKÖ	kkö stems, kkö : kö variations
ADJ_LAKO	ko stems, ko : o ~ ’o variations
ADJ_LATUSKA	a stems, a : o ~ 0 variations
ADJ_LENKO	nko stem, nko : ngo variations
ADJ_LÄHEMPI	mpi stems, mpi : mmä variatios, Lexicalised comparatives, front vowels
ADJ_LÄHTEISYYS	yys stems, yys : yyde variations
ADJ_LÄMMIN	mmin stems, mmin : mpimä variations
ADJ_LÄNTÄ	ntä stems, ntä : nnä variations
ADJ_LÄTYSKÄ	ä stem, ä : ö ~ 0 variations
ADJ_LÖPERÖ	ö stems, no variations
ADJ_LÖRPPÖ	ppö stem, ppö : pö variations
ADJ_MARTO	rto stem, rto : rro variations
ADJ_MATALA	a stem, a : 0 : empi variations
ADJ_MATTA	ta stem,  tta : to variations
ADJ_MELTO	lto stem, lto : llo variations
ADJ_MIETO	to stem, to : do variations
ADJ_MUU	uu stem, uu : u variations
ADJ_MYKKÄ	kkä stem, kkä : k variations
ADJ_MÄRKÄ	kä stem, kä : 0 : empi variations
ADJ_MÄTÄ	tä stem, tä : d variations
ADJ_NELJÄS	s stem, s : nne, front vowel variant, ordinals
ADJ_OHUT	ut stem, ut : ue variation
ADJ_OIKEE	ee stems, colloquial versions of ea stem, lexicalised
ADJ_OPAAKKI	kki stems, kki : ke variations
ADJ_PAHIN	n stems, n : mma variations, lexicalised superlatives, back harmony
ADJ_PANTU	ntu stems, ntu : nnu variations
ADJ_PARANNELTU	ltu stems, ltu : llu variations
ADJ_PARAS	'paras' relexicalised (for parhaampi : parhain)
ADJ_PEEAA	aa stems, aa : a variations
ADJ_PIENI	i stems, i : e variation, consonant stemmed ntä partitives
ADJ_PIKKU	no inflections, like pikku, eri etc.
ADJ_PINKKI	kki stem, kki : ke variations
ADJ_PITKÄ	‘pitkä’, tkä : de variations
ADJ_POHATTA	a stem, tta : t variations
ADJ_POPPA	a stem, ppa : p variations 
ADJ_RAAKA	a stem, ka : ’a variation, obligatory apostrophe
ADJ_RAITIS	tis stem, tis : ttii variations, back harmony
ADJ_RAMPA	mpa stem, mpa : mma : mmempi variations
ADJ_REHTI	ti stems, ti : de variations
ADJ_REIPAS	pas stems, pas : ppaa variation
ADJ_RIETAS	tas stems, tas : ttaa variation
ADJ_RIIVIÖ	ö stems, no variations
ADJ_RUMA	a stems, a : 0 : empi variations
ADJ_RÄVÄKKÄ	kkä stems,.kkä: k(k)ö variation, optional k in plurals
ADJ_SANKA	nka stems, nka : ng variations
ADJ_SIPPI	ppi stems, ppi : pe variations
ADJ_SISIN	n stems, n : mmä varitioans, Lexicalised superlatives, front harmony
ADJ_STYDI	i stems, i : e variations, front harmony
ADJ_SUIPPO	ppo stems, ppo : po variations
ADJ_SUOMALAINEN	nen:se variations back, nationalities etc.
ADJ_SUURI	i stems, i : e variations, consonant stemmed ta partitives
ADJ_SYMPPIS	s stems, s : ks variation, front harmony
ADJ_SYYPÄÄ	ää stems, ää : ä variations
ADJ_SÄIKKY	kky stems, kky : ky variations
ADJ_SÄKKÄRÄ	ä stems, ä : ö ~ 0 variations
ADJ_TARKKA	ka stems, kka : k : kempi variations
ADJ_TERVE	e stems, e : ee variation, front harmony
ADJ_TERÄVÄ	ä stems, ä : 0 : ämpi ~ empi variation
ADJ_TIIVIS	is stems, is : ii variation, front
ADJ_TOINEN	nen stem, nen : se variations, back hamrony, ordinal
ADJ_TOOPE	e stems, no variations
ADJ_TUHTI	ti stems, ti : de variations
ADJ_TUMMAHKO	o stem, no variations
ADJ_TURTA	rta stems, rta : rr variation
ADJ_TYHMÄ	ä stems, ä : 0 : empi variations
ADJ_TYVEN	consonant stems, X : xe variations
ADJ_TYYLIKÄS	käs stems, käs : kkää variations
ADJ_TYÖLÄS	äs stems, äs : ää variations
ADJ_TÄYSI	si stems, si : de variation, front
ADJ_UUSI	si stems, si : de variation, back
ADJ_VALKAISTU	u stems, no variations
ADJ_VALMIS	is stems, is : ii variation, back
ADJ_VAPAA	aa stems, aa : a variations
ADJ_VASEN	n stems, n : mma variations
ADJ_VELTTO	tto stems, tto : to variations
ADJ_VENTO	nto stems, nto : nno variations
ADJ_VIATON	ton stems, ton:ttoma variations, derivations mostl
ADJ_VIHANTA	nta stem, nta : nno variations
ADJ_VIHERIÄ	iä stems, iä : iö variations, archaic
ADJ_VIIPALOITU	tu stems, tu : du variations
ADJ_VIMMATTU	ttu stems, ttu : tu variations
ADJ_VIRKKU	kku stems, kku : ku variations
ADJ_VOIMAKAS	kas stems, kas : kkaa variation
ADJ_VOIPA	pa stems, pa:v variation
ADJ_VÄHÄTELTY	lty stems, lty : lly variations
ADJ_VÄNKÄ	nkä stems, nkä : ng variations
ADJ_VÄÄRTTI	tti stems, tti : te variations
ADJ_YKSILÖITY	ty stems, ty : dy variations
ADJ_YLENNETTY	tty stems, tty : ty variations
ADJ_ÄLLISTYNYT	-yt stem, yt : ee variation, mostly lexicalised nut participles
ADJ_ÖYKKÄRI	i stems, i : e variations
ADP_ALLE	optional possessive including -en allomorph, back harmony
ADP_KOTONA	optional possessive including -an allomorph
ADP_LISÄKSI	i:e stem variation beore optional possessive, -en allomorph, front harmony
ADP_LÄHELLÄ	optional possessive including -än allomorph
ADP_MUKAAN	optional possessive, -n assimilation, back harmony
ADP_MUKAISESTI	adposition without possessives, clitic, back harmony
ADP_NÄHDEN	de:te variation before optional possessive, front harmony
ADP_KUULLEN	le:te variation before optional possessive, front harmony
ADP_NÄKYVIIN	optional possessive, -n assimilation, front harmony
ADP_TYKÖ	optional possessive, front harmony
ADP_VALTAAN	optional possessive, -n assimilation, back harmony
ADP_VUOKSI	i:e stem variation beore optional possessive, -en allomorph, back harmony
ADP_YLLE	optional possessive including -en allomorph, front harmony
ADV_AIKANSA	clitics, back harmony
ADV_HYVILLÄÄN	obligatory possessives in ä stem, front harmony
ADV_IKINÄ	optional possessives
ADV_ILKOSILLAAN	obligatory possessives in a stem, back harmony
ADV_ISTUALLEEN	obligatory possessives in e stem, back harmony
ADV_JO	Adverbs that can only take ko clitic
ADV_JONNE	optional clitics, including ka
ADV_KUHUN	optional clitics, including kas
ADV_LEVÄLLEEN	obligatory possessives in e stem, front harmony
ADV_MITEN	optional clitics, including käs
ADV_NOPEASTI	optional clitics, back harmony
ADV_TYHMÄSTI	optional clitics, front harmony
ADV_VAAN	no clitics
ADV_YLIPÄÄNSÄ	optional clitics, front harmony
AUX_AIKOA	auxiliary version of ko:o verb stem
AUX_EI	Negation verb ‘ei’ has heteroclitic inflection
AUX_JOUTUA	auxiliary version of tu:du verb stem
AUX_MAHTAA	auxiliary version of ta:do verb stem
AUX_OLLA	auxiliary version of ‘olla’
AUX_PITÄÄ	auxiliary version of tä:dä verb stem
AUX_SAATTAA	auxiliary version of ttaa:to verb stem
AUX_TAITAA	auxiliary version of ta:si verb stem
AUX_TARVITA	auxiliary version of ta:tse verb stem
AUX_TÄYTYÄ	auxiliary version of ty:dy verb stem
AUX_VOIDA	auxiliary version of voida verb stem
CCONJ_JA	co-ordinating conjunction, no morphology
DET_SE	determiner version of pronoun ‘se’
DET_YKSI	determiner version of pronoun/numeral ‘yksi’
INTJ_HAH	interjection that does *not* participate in interjection compounding
INTJ_OO	interjection that participates in interjection compounding
NOUN_51aamukaksitoista	Nouns inflecting like 'kaksitoista', e.g. noun-numeral compounds
NOUN_51aamuyksitoista	Nouns inflecting like 'yksitoista', e.g. noun-numeral compounds
NOUN_51aavameri	Optimisation hack for exceptional compound ’aavameri’
NOUN_51hienosokeri	Optimisation hack for exceptional compound ’hienosokeri’
NOUN_51isojako	Optimisation hack for exceptional compound ’isojako’
NOUN_51isokoskelo	Optimisation hack for exceptional compound ’isokoskelo’
NOUN_51isokuovi	Optimisation hack for exceptional compound ’isokuovi’
NOUN_51isokäpylintu	Optimisation hack for exceptional compound ’isokäpylintu’
NOUN_51isolepinkäinen	Optimisation hack for exceptional compound ’isolepinkäinen’
NOUN_51isolokki	Optimisation hack for exceptional compound ’isolokki’
NOUN_51isomaksaruoho	Optimisation hack for exceptional compound ’isomaksaruoho’
NOUN_51isomasto	Optimisation hack for exceptional compound ’isomasto’
NOUN_51isopanda	Optimisation hack for exceptional compound ’isopanda’
NOUN_51isopistooli	Optimisation hack for exceptional compound ’isopistooli’
NOUN_51isopurje	Optimisation hack for exceptional compound ’isopurje’
NOUN_51isorokko	Optimisation hack for exceptional compound ’isorokko’
NOUN_51isorumpu	Optimisation hack for exceptional compound ’isorumpu’
NOUN_51isosisar	Optimisation hack for exceptional compound ’isosisar’
NOUN_51isosisko	Optimisation hack for exceptional compound ’isosisko’
NOUN_51isotaivot	Optimisation hack for exceptional compound ’isotaivot’
NOUN_51isovarvas	Optimisation hack for exceptional compound ’isovarvas’
NOUN_51isoveli	Optimisation hack for exceptional compound ’isoveli’
NOUN_51isoviha	Optimisation hack for exceptional compound ’isoviha’
NOUN_51karkearehu	Optimisation hack for exceptional compound ’karkearehu’
NOUN_51kevytsarja	Optimisation hack for exceptional compound ’kevytsarja’
NOUN_51kirjavapillike	Optimisation hack for exceptional compound ’kirjavapillike’
NOUN_51kuivakakku	Optimisation hack for exceptional compound ’kuivakakku’
NOUN_51kuivakukka	Optimisation hack for exceptional compound ’kuivakukka’
NOUN_51kuivamuona	Optimisation hack for exceptional compound ’kuivamuona’
NOUN_51kuivapaino	Optimisation hack for exceptional compound ’kuivapaino’
NOUN_51kuivapari	Optimisation hack for exceptional compound ’kuivapari’
NOUN_51kuivarehu	Optimisation hack for exceptional compound ’kuivarehu’
NOUN_51kultainennoutaja	Optimisation hack for exceptional compound ’kultainennoutaja’
NOUN_51laiskakoira	Optimisation hack for exceptional compound ’laiskakoira’
NOUN_51lämminruoka	Optimisation hack for exceptional compound ’lämminruoka’
NOUN_51lämminvarasto	Optimisation hack for exceptional compound ’lämminvarasto’
NOUN_51lämminvaunu	Optimisation hack for exceptional compound ’lämminvaunu’
NOUN_51matalameri	Optimisation hack for exceptional compound ’matalameri’
NOUN_51mustaherukka	Optimisation hack for exceptional compound ’mustaherukka’
NOUN_51mustaleipä	Optimisation hack for exceptional compound ’mustaleipä’
NOUN_51mustaleski	Optimisation hack for exceptional compound ’mustaleski’
NOUN_51mustalintu	Optimisation hack for exceptional compound ’mustalintu’
NOUN_51mustamaija	Optimisation hack for exceptional compound ’mustamaija’
NOUN_51mustamakkara	Optimisation hack for exceptional compound ’mustamakkara’
NOUN_51mustamies	Optimisation hack for exceptional compound ’mustamies’
NOUN_51mustamulta	Optimisation hack for exceptional compound ’mustamulta’
NOUN_51mustapekka	Optimisation hack for exceptional compound ’mustapekka’
NOUN_51mustapippuri	Optimisation hack for exceptional compound ’mustapippuri’
NOUN_51mustaraamattu	Optimisation hack for exceptional compound ’mustaraamattu’
NOUN_51mustatorvisieni	Optimisation hack for exceptional compound ’mustatorvisieni’
NOUN_51mustaviinimarja	Optimisation hack for exceptional compound ’mustaviinimarja’
NOUN_51nuori-isäntä	Optimisation hack for exceptional compound ’nuori-isäntä’
NOUN_51nuoriemäntä	Optimisation hack for exceptional compound ’nuoriemäntä’
NOUN_51nuoriherra	Optimisation hack for exceptional compound ’nuoriherra’
NOUN_51nuorikarja	Optimisation hack for exceptional compound ’nuorikarja’
NOUN_51nuorimies	Optimisation hack for exceptional compound ’nuorimies’
NOUN_51nuoripari	Optimisation hack for exceptional compound ’nuoripari’
NOUN_51omakuva	Optimisation hack for exceptional compound ’omakuva’
NOUN_51omatunto	Optimisation hack for exceptional compound ’omatunto’
NOUN_51pahahenki	Optimisation hack for exceptional compound ’pahahenki’
NOUN_51pahaputki	Optimisation hack for exceptional compound ’pahaputki’
NOUN_51palavakivi	Optimisation hack for exceptional compound ’palavakivi’
NOUN_51palavapensas	Optimisation hack for exceptional compound ’palavapensas’
NOUN_51palavarakkaus	Optimisation hack for exceptional compound ’palavarakkaus’
NOUN_51pitkähousu	Optimisation hack for exceptional compound ’pitkähousu’
NOUN_51pitkäkirkko	Optimisation hack for exceptional compound ’pitkäkirkko’
NOUN_51pitkäperjantai	Optimisation hack for exceptional compound ’pitkäperjantai’
NOUN_51pitkäpiimä	Optimisation hack for exceptional compound ’pitkäpiimä’
NOUN_51pitkäsiima	Optimisation hack for exceptional compound ’pitkäsiima’
NOUN_51pitkätakki	Optimisation hack for exceptional compound ’pitkätakki’
NOUN_51pitkäthousut	Optimisation hack for exceptional compound ’pitkäthousut’
NOUN_51puolikuu	Optimisation hack for exceptional compound ’puolikuu’
NOUN_51puolimatka	Optimisation hack for exceptional compound ’puolimatka’
NOUN_51puolipäivä	Optimisation hack for exceptional compound ’puolipäivä’
NOUN_51puoliväli	Optimisation hack for exceptional compound ’puoliväli’
NOUN_51puoliyö	Optimisation hack for exceptional compound ’puoliyö’
NOUN_51raitisilma	Optimisation hack for exceptional compound ’raitisilma’
NOUN_51raskassarja	Optimisation hack for exceptional compound ’raskassarja’
NOUN_51raskasvesi	Optimisation hack for exceptional compound ’raskasvesi’
NOUN_51raskasvety	Optimisation hack for exceptional compound ’raskasvety’
NOUN_51sepiväpeippi	Optimisation hack for exceptional compound ’sepiväpeippi’
NOUN_51suorakulma	Optimisation hack for exceptional compound ’suorakulma’
NOUN_51suoraommel	Optimisation hack for exceptional compound ’suoraommel’
NOUN_51syvämeri	Optimisation hack for exceptional compound ’syvämeri’
NOUN_51särkynytsydän	Optimisation hack for exceptional compound ’särkynytsydän’
NOUN_51tyhjäpaino	Optimisation hack for exceptional compound ’tyhjäpaino’
NOUN_51täysikuu	Optimisation hack for exceptional compound ’täysikuu’
NOUN_51uusikuu	Optimisation hack for exceptional compound ’uusikuu’
NOUN_51uusivuosi	Optimisation hack for exceptional compound ’uusivuosi’
NOUN_51vanhaemäntä	Optimisation hack for exceptional compound ’vanhaemäntä’
NOUN_51vanhaisäntä	Optimisation hack for exceptional compound ’vanhaisäntä’
NOUN_51vanhakaupunki	Optimisation hack for exceptional compound ’vanhakaupunki’
NOUN_51vanhapiika	Optimisation hack for exceptional compound ’vanhapiika’
NOUN_51vanhapoika	Optimisation hack for exceptional compound ’vanhapoika’
NOUN_51vierasmies	Optimisation hack for exceptional compound ’vierasmies’
NOUN_AAKKOSELLISUUS	s stem, s:de:te variation
NOUN_AAKKOSTAMINEN	nen stem, nen:se variation
NOUN_AALLOT	Plurale tantums, llot:lto variation
NOUN_AAMUKAHDEKSAN	Nouns inflecting like 'kahdeksan', e.g. noun-numeral compounds
NOUN_AAMUKAKSI	Nouns inflecting like 'kaksi', e.g. noun-numeral compounds
NOUN_AAMUKOLME	Nouns inflecting like 'kolme', e.g. noun-numeral compounds
NOUN_AAMUKYMMENEN	Nouns inflecting like 'kolme', e.g. noun-numeral compounds
NOUN_AAMUYHDEKSÄN	Nouns inflecting like 'yhdeksän', e.g. noun-numeral compounds
NOUN_AAMUYKSI	Nouns inflecting like 'yksi', e.g. noun-numeral compounds
NOUN_AARRE	rre-stem, rre:rtee variation back harmony
NOUN_ACRO_AA	acronyms ending in 'a' pronounced as a letter
NOUN_ACRO_CELSIUS	The acronyms ending in a word that inflects like ‘celsius’, s:kse type stem
NOUN_ACRO_DOLLARI	The acronyms ending in a word that inflects like ‘dollari’, i:e type stem
NOUN_ACRO_EE	acronyms ending in 'b', 'c', 'd', 'e', 'g', 'p', 'v', 'w' or 't' pronounced as a letter
NOUN_ACRO_GRAMMA	The acronyms ending in a word that inflects like ‘gramma’, a:o type stem
NOUN_ACRO_GRAY	The acronyms ending in a word that inflects like ‘gray’, y type stem
NOUN_ACRO_II	Acronyms that end in 'j' or 'i' pronoynced as letter
NOUN_ACRO_JOULE	The acronyms ending in a word that inflects like ‘joule’, e type stem
NOUN_ACRO_JÄRJESTÖ	The acronyms ending in a word that inflects like ‘järjestö’, ö type stem
NOUN_ACRO_KAHDEKSAN	Acronyms ending in 8
NOUN_ACRO_KAKSI	Acronyms ending in 2
NOUN_ACRO_KANDELA	The acronyms ending in a word that inflects like ‘kandela’, a:0 type stem
NOUN_ACRO_KOLME	The acronyms ending in digit 3 pronounced as number
NOUN_ACRO_KUUSI	Acronyms ending in 6
NOUN_ACRO_LEHTI	The acronyms ending in a word that inflects like ‘lehti’, i:e type stem
NOUN_ACRO_LUSIKKA	The acronyms ending in a word that inflects like ‘lusikka’, a:o type stem
NOUN_ACRO_METRI	The acronyms ending in a word that inflects like ‘metri’, i:e type stem
NOUN_ACRO_NELJÄ	Acronyms ending in 4
NOUN_ACRO_NOLLA	The acronyms ending in digit 0 pronounced as a number
NOUN_ACRO_OIKEUS	The acronyms ending in a word that inflects like ‘oikeus’, s:de type stem
NOUN_ACRO_OK	The acronyms ending in a word that inflects like ‘ookoo’, o:0 type stem
NOUN_ACRO_OO	Acronyms that end in 'h', 'k' or 'o' that is pronounced as a letter
NOUN_ACRO_OPISTO	The acronyms ending in a word that inflects like ‘opisto’, o type stem
NOUN_ACRO_PUNTA	The acronyms ending in a word that inflects like ‘punta’, a:0 type stem
NOUN_ACRO_SAIRAALA	The acronyms ending in a word that inflects like ‘punta’, a:o type stem
NOUN_ACRO_SEITSEMÄN	Acronyms ending in 7
NOUN_ACRO_TUOTE	The acronyms ending in a word that inflects like ‘tuote’, e:ee type stem
NOUN_ACRO_UU	Acronyms that end in 'q', or 'u' pronounced as a letter
NOUN_ACRO_VIISI	The acronyms ending in digit 5 pronounced as number
NOUN_ACRO_VUOSI	The acronyms ending in a word that inflects like ‘vuosi’, i:e type stem
NOUN_ACRO_WEBER	The acronyms ending in a word that inflects like ‘weber’, r:re type stem
NOUN_ACRO_YHDISTYS	The acronyms ending in a word that inflects like ‘yhdistys’, s:kse type stem
NOUN_ACRO_YKSI	Acronyms ending in 1
NOUN_ACRO_YY	Acronym that ends in 'y' pronounced as letter
NOUN_ACRO_ZET	Acronyms that end in 'z' pronounced as letter
NOUN_ACRO_ÄKS	Acronym that ends in 'f', 'l', 'm', 'n', 'r', 's', 'š' or 'x' pronounced as a letter
NOUN_ACRO_ÄÄ	Acronyms that end in 'ä' pronounced as letter
NOUN_ACRO_ÖÖ	Acronyms that end in 'ö' pronounced as letter
NOUN_ACRO_Ω	Acronyms that end in ‘oomega’
NOUN_AIDS	inflects both normally and as an acronym ending in S or such
NOUN_AIKA	Nouns that inflect like aika:aja
NOUN_AIVOKUOLLUT	llut stem that inflect, llut : llee variation
NOUN_AIVOT	Plurale tantums, ot stem that inflect without variation (o stem)
NOUN_AJATAR	tar stem that inflect, tar : ttare variation
NOUN_ALKEET	Plurale tantums, lkeet stem that inflects, lkeet : lje variation
NOUN_ALKU	ku stem, ku : u variation
NOUN_ALLAS	Nousn, llas stem, llas : ltaa variation
NOUN_ANTIMET	Plurale tantums, ntimet stem, ntimet : nnin variation
NOUN_APE	pe stem, pe : ppee variation
NOUN_APU	pu stem, pu : vu variation
NOUN_ARKI	rki stem, rki : rje variation
NOUN_ARKKITEHTI	ti stem, ti : di variation both harmonious accepted
NOUN_ASEMA	a stem, a : 0 variation
NOUN_ASKAR	r stem, r : re : ree variations back harmony
NOUN_ASKELLIN	llin stem, llin : ltime variation back harmony
NOUN_ASTE	e stem, e : ee variation back harmony
NOUN_ASU	Nouns ending in u without variation, the bisyllabic ones have the same simple allomorph pattern
NOUN_ASUKAS	kas stem, kas : kkaa variation
NOUN_ATERIMET	Plurale tantums, met : n variation back harmony
NOUN_AUER	Noun(s), er stem, er : tere variation
NOUN_BEIGNET	loan word nouns, consonant stem, ’ inflection, e stem and front harmony
NOUN_BERNIE	ie stems, front harmony
NOUN_BESSERWISSER	loan word nouns, consonant stem, x : xi inflection
NOUN_BIDEE	ee stem, more syllables, ee : e variation
NOUN_BIKINIT	it stem, it : i variation front harmony
NOUN_BORDEAUX	Loan word nouns, ’ inflection, o stem back harmony
NOUN_BRASSERIE	Loan word nouns, e stems, front harmony
NOUN_BRIE	Loan word nouns, e stems, front harmony
NOUN_BÄNET	Plurale tantums, et stems et : e variation, front harmony
NOUN_BÉBÉ	é stem front harmony
NOUN_CHACHACHA	Loan words, a stem
NOUN_COWBOY	oy stem, both harmonies
NOUN_ELIN	n stem, n : me variation front harmony
NOUN_ELÄMÄ	ä stem, ä : 0 variation
NOUN_EPÄILTY	lty stem, lty : lly variation, mostly l-stem passive participles lexicalised
NOUN_ESIM.	Abbreviated nouns, final full stop, no morphology. At the moment covers parts-of-speech, may be split in the future
NOUN_ESQUIMAU	Loan words, o stem
NOUN_FARKUT	Plurale tantums, kut stem, kut :kku variation
NOUN_FARMARIT	Plurale tantums, it stem, it : i variation and back harmony
NOUN_FIM	inflects both normally and as an acronym ending in M or such
NOUN_FONDUE	Loan words wit y stem, stuff
NOUN_FONDYY	yy stem, more syllables
NOUN_FÄNRIKIT	it stem, it : i variation, front harmony
NOUN_GAY	Loan words, y stem, front harmony
NOUN_HAAKSI	ksi stem, ksi : ht variations
NOUN_HAI	i stem, i : 0 variation, back harmony
NOUN_HAIT	Plurale tantum monosyllabic nouns ending in i, back harmony
NOUN_HAKKUUT	Plurale tantums, kkuut stem, kkuut : tuu variations
NOUN_HAMMAS	mas stem, mmas : mpaa variation
NOUN_HAPAN	n stem, n:ma variation, e.g. noun compounds, 'hapan'
NOUN_HAPPI	ppi stem, ppi : pe variations, back harmony
NOUN_HAPPO	ppo stem, ppo : po variations
NOUN_HAPSI	psi stem, psi : pse variations back harmony
NOUN_HARMAAT	Plurale tantums, aat stem, aat : aa variations
NOUN_HAŠIŠ	š stem, š : ks variations back harmony
NOUN_HEITIN	tin stem, tin : ttime variation, front harmony
NOUN_HENKI	nki stem, nki : nge variations
NOUN_HEPO	po stem, po : vo variations
NOUN_HIIRI	i stem, i : e variations. It is noteworthy of the official dictionary classification, that classes, numbers 24 and 26 are identical. The distinction should probably not be retained in future versions.
NOUN_HIPAT	Plurale tantums, pat stem, pat : ppa variations
NOUN_HIRTTO	tto stem, tto : to variations
NOUN_HIUTALEET	Plurale tantums, leet stem, leet : lee : le variations
NOUN_HIV	inflects both normally and as an acronym ending in V or such
NOUN_HOKSOTTIMET	Plurale tantums, timet stem, timet : tin variations
NOUN_HONKA	nka stem, nka : ng variations 
NOUN_HOPEAT	Plurale tantums, eat stem, eat : e variations
NOUN_HOUSUT	Plurale tantums, ut stem, ut : u variations
NOUN_HUOLITELTU	Nousn, ltu stem, ltu : llu variations, mostly lexicalised passive participles
NOUN_HUPI	pi stem, pi : vi variations, back harmony
NOUN_HYLJE	je stem, je : ke variations, front harmony
NOUN_HYLKY	ky stem, ky : y variations 
NOUN_HYNTTEET	Plurale tantums, ntteet stem, ntteet : nte variation, front harmony
NOUN_HYNTTYYT	Plurale tantums, nttyyt stem, nttyyt : nty variation
NOUN_HÄIRIÖ	iö stem, no variations
NOUN_HÄKKI	ki stem, kki : ki variations
NOUN_HÄKKYRÄ	ä stem, ä : ö : 0 variations
NOUN_HÄMMINKI	nki stem, nki : ng variations front harmony
NOUN_HÄNTÄ	ntä stems, ntä : nnä variations
NOUN_HÄRKIN	kin:kkime variation, front
NOUN_HÄVINNEET	Plurale tantusm wit nneet stem, nneet : nyt variations
NOUN_HÄÄT	Plurale tantums, äät stem, äät : ää : ä variations
NOUN_HÄÄTÖ	tö stem, tö : dö variations
NOUN_HÖLKKÄ	kkä stem, kkä : k variations
NOUN_HÖPÖTTÄJÄ	ä stem, ä : 0 variations
NOUN_HÖYHENET	Plurale tantums, et stem, et : 0 variations, front harmony
NOUN_IEN	en stem, en : kene variations 
NOUN_IES	es stem, es : kee variations
NOUN_IKENET	kenet stem, kenet : en variations
NOUN_IMMYT	myt stem, myt :  py variations
NOUN_ITÄMAAT	Plurale taantums, aat stems, aat : aa : a variations
NOUN_JEPPE	ppe stem, ppe : pe variations
NOUN_JOCKEY	Loan words, ey stems, both harmonies
NOUN_JOUKOT	Plurale tantums, kot stem, kot :kko varaitions 
NOUN_JOUTSEN	consonant stem, x : xe variations
NOUN_JUHLAT	Plurale tantums, at stem, at : a : 0 variations
NOUN_JUMALA	a stem a:0 variations,, a consonant stem ten genitive
NOUN_JÄLSI	lsi stem, lsi : lle variations, front harmony
NOUN_JÄRKI	rki stem, rki : rje  variations, front harmony
NOUN_JÄÄTELÖ	ö stem, no variations
NOUN_KAMPPEET	Plurale tantums, ppeet stem, ppeet : pe variations
NOUN_KANAALI	i stem, i:e variation back harmony
NOUN_KANGAS	gas stem, gas : kaa variations
NOUN_KANNEL	nel stem, nel : tele variations
NOUN_KANNET	Plurale tantums, nnet stem, nnet : nsi variations
NOUN_KARBOKSYLAATTI	tti stem, tti : t variations and, both back, front harmonies
NOUN_KASTANJETIT	Pluarale tantums, tit stem, tit : tti variations
NOUN_KASTIKE	ke stem, ke : kkee variations, back harmony
NOUN_KASTILJAT	Plurale tantums, at stem, a:o variations
NOUN_KAUSI	si stem, si : de variations
NOUN_KEHVELI	i stem, i : e variations
NOUN_KELTIS	tis stem, tis : ttii variations
NOUN_KENGÄT	Plurale tantums, ngät stems, ngät : nkä  variations
NOUN_KENKÄ	nkä stems, nkä : ng variations
NOUN_KENTTÄ	ttä stems, ttä : t  variations
NOUN_KERITSIMET	Plurale tantums, imet stem, imet : in variations
NOUN_KERROIN	rroin stem, rroin : rtoime variations
NOUN_KERTA	rta stem, rta : rro variations
NOUN_KEVÄT	ät stem, ät : ää variations
NOUN_KIDE	de stem, de : tee variations
NOUN_KIELTO	lto stem, lto : llo variations
NOUN_KIERRE	rre stem, rre : rtee variations front harmony
NOUN_KIERRIN	rrin stem, rrin : rtime variations front harmony
NOUN_KIHARAT	Plurale tantums, at stem, at : 0 : o variations
NOUN_KIHARRIN	rrin stem, rrin :rtime variations back harmony
NOUN_KIINNE	nne stem, nne : ntee variations front harmony
NOUN_KIIRU	u stem, u : uu variations, archaic, c.f., s.v kiiruusti etc.
NOUN_KILPI	pi stems, pi : ve variations
NOUN_KILPIKKÄÄT	Plurale tantums, kkäät stem, kkäät : käs variations
NOUN_KINNAS	nnas stem, nnas : ntaa variations.
NOUN_KINNER	nner stem, nner : ntere : nteree variations front harmony
NOUN_KIRJA	a stem, a : o variations
NOUN_KIRVES	es stem, es : ee ( : ekse ) variations
NOUN_KITARA	a stem, a : o variations
NOUN_KIVI	i stem, i : e variations
NOUN_KLUMPIT	Plural-only noun, pit stem, pit : ppi variations
NOUN_KOE	e stem, e : kee variations back harmony
NOUN_KOKO	koko stem, k : ’ : 0 variations, N.B. should be obligatory k : ’ but new rules allow k:0 for ‘koko’
NOUN_KOMPA	mpa stem, mpa : mm variations
NOUN_KORPI	pi stem, pi : ve variations back harmony
NOUN_KORTTI	tti stem, tti : te variations
NOUN_KUITU	tu stem, tu : du variations
NOUN_KUNGFU	Loan word nouns, u stem 
NOUN_KUNTA	nta stem, nta : nna variations
NOUN_KUOPAT	Plurale tantums, pat stem, pat : ppa variations
NOUN_KUOPPA	ppa stem, ppa : pa variations
NOUN_KUPPI	ppi stem, ppi : pe variations
NOUN_KUTSUNTA	nta stem, nta : nna variations
NOUN_KUULOKKEET	Plurale tantums, kkeet stems, kkeet : kee variations
NOUN_KYDÖT	Plurale tantums, döt stems, döt : tö variations
NOUN_KYKY	yky stems, yky : yvy variations
NOUN_KYLKIÄINEN	nen stem, nen : se variations front harmony
NOUN_KYLÄNVANHIN	in stem, in : imma variations, mainly lexicalised superlatives as nouns, front harmony
NOUN_KYSYNTÄ	ntä stem, ntä : nnä variations
NOUN_KYYNEL	el stem, el : ele : elee variations front harmony
NOUN_KÄKI	ki stem, ki : e variation front harmony
NOUN_KÄMMEKKÄ	kkä stem, kkä : kö variation
NOUN_KÄPY	py stem, py : vy variatons
NOUN_KÄPÄLÄ	ä stem, ä : ö : 0 variations
NOUN_KÄRRY	y stem no variations
NOUN_KÄRSÄKÄS	käs stem, käs : kkää variations
NOUN_KÄRÄJÄT	Plurale tantums, ät stems, ät : 0 variations
NOUN_KÄSITE	te stem, te : ttee variations
NOUN_KÄTTÄPIDEMPI	mpi stem, mpi : mmä variations
NOUN_KÄÄDYT	Plurale tantums, dyt stem, dyt : ty variatons
NOUN_KÄÄNNIN	nnin stems, nnin : ntime variations, front harmony
NOUN_KÄÄNTÖ	ntö stem, ntö : nnö variations
NOUN_KÖNGÄS	ngäs stem, ngäs : nkää variations
NOUN_KÖYHYYS	s stem, s : de 
NOUN_KÖYSI	si stem, si : de variations
NOUN_KÖÖ	öö stem, öö : ö variations
NOUN_LAHTI	ti stem, ti : de variations
NOUN_LAIDUN	dun stem, dun : tume variations
NOUN_LAKI	ki stem, ki : i variations
NOUN_LANKA	nka stem, nka : ngo variations
NOUN_LAPSI	psi stem, psi : s variations
NOUN_LASIT	Plurale tantums, sit stem, sit : se variations
NOUN_LEHTI	ti stem, ti : de variations
NOUN_LEIKKUU	uu stem, uu : u variations
NOUN_LEIPÄ	pä stem, pä : v variations
NOUN_LEPAKKO	kko stems, kko : ko variations
NOUN_LIEMI	mi stems, mi : n variations, front harmony
NOUN_LIITTOUTUNEET	Plurale tantums, neet stem, neet : nut variations
NOUN_LIIVIT	Plurale tantums, it stem, it : e varaitions
NOUN_LINTU	ntu stems, ntu : nnu variations
NOUN_LIPEÄ	eä stems, eä : e variations
NOUN_LIPPU	ppu stems, ppu : pu variations
NOUN_LIUKU	uku stems, and uku : u’u variations
NOUN_LOKA	ka stems, ka : 0 variations
NOUN_LOKKI	kki stems, kki : ke variations
NOUN_LUHDAT	Plurale tantums, dat stems, dat:t variatiosn 
NOUN_LUKU	uku stems, uku : uvu variations
NOUN_LUMME	mme stems, mme : mpee variations
NOUN_LUODE	de stems, de : tee variations back harmonu
NOUN_LUOKKA	kka stems, kka : k varaitions
NOUN_LUOLIKOT	Plurale tantums, kko stems, kko : ko variations
NOUN_LUPA	pa stems, pa : v variations
NOUN_LUSIKKA	kka stems, kka : ko variations
NOUN_LÄHIN	in stem, in : immä variations, mostly lexicalised superlatives and compounds thereof
NOUN_LÄMMIN	mmin stem, mmin : mpimä variations, ostly lexicalised superlatives and compounsds thereof
NOUN_LÄMPÖ	mpö stems, mpö : mmö variations 
NOUN_LÄNGET	nget stems, nget : nki variations front harmony
NOUN_LÄNSI	nsi stems, nsi : nne variations front harmony
NOUN_LÄÄKE	ke stem, ke : kkee variations front harmony
NOUN_LÖPÖ	pö stems, pö : vö variations
NOUN_MAA	aa stems, aa : a variations
NOUN_MAKKARA	a stems, a : o  variations
NOUN_MAKU	ku stems, ku : u variations 
NOUN_MALTAAT	Plurale tantums, ltaat stems, ltaat : llas variations
NOUN_MANNER	nner stems, nner : ntere : nteree variations
NOUN_MARKKINAT	Plurale tantums, at stems, at : o variations
NOUN_MATEE	long ee stem, back harmony
NOUN_MERI	meri stems, i : e variations and tä partitive
NOUN_MIELLE	lle stems , lle : ltee variations front harmony
NOUN_MIES	s stem, s : he variations
NOUN_MILJÖÖ	öö stems, öö : ö variations
NOUN_MILJÖÖT	Plurale tantums, ööt stems, ööt : ö variations
NOUN_MITTA	tta stems, tta : to variations
NOUN_MONSIEUR	consonant stem, ’ inflection, front harmony
NOUN_MULTA	lta stem, lta : lla variation
NOUN_MUUNNIN	nnin stem, nnin : ntime variations, back harmony
NOUN_MYRKKY	kky stems, kky : ky variations
NOUN_MÄNTY	nty stems, nty : nny variations
NOUN_MÄTÄS	täs stems, täs : ttää variations
NOUN_MÖMMÖ	ö stem, no variations
NOUN_MÖRKÖ	kö stem, kö : ö variations
NOUN_NAHKA	hka stems, both hka : h0 and hka : hk variations
NOUN_NALLE	e stem, no variations, back harmony
NOUN_NEITSYT	yt stem, yt : ye variations
NOUN_NEUVOTTELUT	Plurale tantums, ut stem, ut : u variations
NOUN_NIHTI	ti stem, ti : de variations
NOUN_ÄITI	ti stem, optional t : d
NOUN_NIITUT	Plurale tantums, tut stem, ttut : tu variations
NOUN_NIMETÖN	tön stem, tön : ttömä variations
NOUN_NISSE	e stem, no variations front harmony
NOUN_NOKI	ki stem, ki : e variations back harmony
NOUN_NOUGAT	consonant stem, ’ inflection back harmony
NOUN_NRO	Abbreviated nouns without final full stop, no inflection. At the moment covers all nominal parts-of-speech, may be split in the future
NOUN_NUGAA	aa stems, aa : a variations
NOUN_NUKKE	kke stems, kke : ke variations
NOUN_NYLJIN	jin stem, jin : kime variations front harmony
NOUN_NÄKY	ky stem, ky : y variations
NOUN_NÄKÖ	kö stem, kö : ö variations
NOUN_NÄLKÄ	kä stem, kä : ä variations
NOUN_OIKEUDET	Plurale tantums, det stem, det : s variations
NOUN_OLKA	ka stem, ka : a variations
NOUN_OLUT	t stem, t : e variations
NOUN_OMMEL	mmel stem, mmel : mpele : mpelee variations
NOUN_ONKI	nki stem, nki : nge variations back harmony
NOUN_ONNET	Plurale tantums, et stem et : i variation
NOUN_ONNI	i stem, i : e variations
NOUN_OOKOO	oo stem, oo : o variations
NOUN_OPINNOT	Plurale tantums, nnot stem, nnot : nto variations
NOUN_ORI	i stem, i : ii variation, archaic, back harmony
NOUN_OSATON	ton stem, ton : ttoma variations
NOUN_OSOITE	te stem, te : ttee variations back harmony
NOUN_PAIKAT	Plurale tantums, kat stem, kat : kko variations
NOUN_PANKIT	Plurale tantums, kk:k, i:e variations
NOUN_PARFAIT	consonant stem, ’ inflections, back harmony
NOUN_PATA	ta stem,, ta : do variations
NOUN_PATEE	ee stem, ee : e variations
NOUN_PATSAS	as stem, as : aa variations
NOUN_PEIPOT	Plurale tantums, ot stems, pot : ppo variations
NOUN_PELKO	ko stem, ko : o variations
NOUN_PELTI	lti stem, lti : lle vaariations front harmony
NOUN_PENGER	nger stem, nger : nkere : nkeree variations
NOUN_PERKEET	Plurale tantums, keet stem, keet : je variations
NOUN_PIDOT	Plurale tantums, dot stem, dot : to variations
NOUN_PIENNAR	nnar stem, nnar : ntare : ntaree variations
NOUN_PIHDIT	Plurale tantums, dit stems, dit : te variations front harmony
NOUN_PII	ii stem, ii : i variations?
NOUN_PIIROA	oa stem, oa : o variations
NOUN_PINSETIT	Plurale tantums, tit stem, tit:te variations
NOUN_PIPPALOT	Plurale tantums, ot stem, ot : o variations
NOUN_PISTE	e stem, e : ee variations front harmony
NOUN_POHATTA	tta stem, tta : to variations
NOUN_POHJE	je stem, je : kee variations
NOUN_POIKA	ika stem, ika : j variations
NOUN_POIUT	poiut stem, 
NOUN_POJAT	Plurale tantums, jat stem, jat : ika variations
NOUN_POLITIIKKA	kka stem, kka : ko variations
NOUN_POLJIN	jin stem, jin : kime variations back variations
NOUN_PONSI	nsi stem, nsi : nne variations back harmony
NOUN_PORRAS	rras stem, rras : rtaa variations
NOUN_PORTAAT	Plurale tantums, rtaat stem, rtaat : ras variations
NOUN_PROBLEEMA	a stem, a : 0 variations
NOUN_PROTOLYYSI	i stem, i : e variations both harmonies
NOUN_PROTOLYYTTI	tti stem, tti : te variations both front and back harmony allowed
NOUN_PUHELIN	n stem, n : me variations back harmony
NOUN_TEIN	in stem, in : kime variations front
NOUN_PUIN	in stem, in : kime variations back
NOUN_PUKIMET	Plurale tantums, kimet stem,  kimet : in variations
NOUN_PUNK	consonnat stems, x : xe variations, mainly new loan words, back harmony
NOUN_PUU	uu stem, uu : u variations
NOUN_PUUT	Plurale tantums, uut stem, uut : u variations
NOUN_PYRAMIDI	i stem, i : e variations both harmonies
NOUN_PYTTY	ty stem, tty : ty variations
NOUN_PYY	yy stem, yy : y variations
NOUN_PYYHE	e stem, e : kee variations, front harmony
NOUN_PYYHIN	in stem, in : kime variations, front harmonu
NOUN_PYYT	Plurale tantums, yyt stem, yyt : y variiations
NOUN_PÄÄ	Nousn, ää stem, ää : ä variations
NOUN_PÖKSYT	Plurale tantums, yt stems, no variations
NOUN_PÖLLÖT	Plurale tantums, öt stems, no variatins 
NOUN_PÖNTTÖ	ttö stem, ttö : tö variations
NOUN_PÖYTÄ	tä stem, tä : t variations
NOUN_RAAVIN	vin stem, vin : pime variations
NOUN_RAGUU	uu stem, uu : u variations
NOUN_RAKENNE	nne stem nne : ntee variations back harmony
NOUN_RAMPA	mpa stem mpa : mma variations
NOUN_RANGAT	Plurale tantums, ngat stems, ngat : nka variations
NOUN_RAPPUSET	Plurale tantums, set stem, set : nen variations back harmony
NOUN_RAPUT	Plurale tantums, put stem, put : ppu variations
NOUN_RATAS	tas stem, tas : ttaa variations
NOUN_RATTAAT	Plurale tantums, ttaat stem, ttaat : tas variations
NOUN_RAUDAT	Plurale tantums, dat stem, dat : ta variations
NOUN_RAUNIOT	Plurale tantums, ot stem, no varioatns
NOUN_RAVET	Plurale tantums, et stems, no variaitons back harmony
NOUN_RAVUT	PLurale tantums, vut stems, vut : pu variations
NOUN_REGGAE	ae stems
NOUN_REIKÄ	kä stem, kä : 0 : ’ variations
NOUN_RENKAAT	Plurale tantums, nkaat stems, nkaat: ngas variations
NOUN_RIMPI	mpi stems, mpi : mm variations
NOUN_RIPE	pe stem, pe : ppee variations
NOUN_RIPSET	Plurale tantums, et stem, et : i variations
NOUN_RIUTAT	Plurale tantums, tat stems, tat : tto variations
NOUN_ROHTIMET	Plurale tantums, timet stems, timet : din variations
NOUN_ROSÉ	é stems no variations
NOUN_ROTAT	Plurale tantums, tat stem, tat : tt variations
NOUN_ROTTA	tta stem, tta : t variations
NOUN_RUIPELO	o stem, no variations
NOUN_RUIS	is stem, is : kii variations back harmony
NOUN_RUMPU	mpu stem, mpu : mmu variatons
NOUN_RUNKO	nko stem, nko : ngo variatins
NOUN_RUOKA	uoka stem, uoka : uo’a : uoa : uu variations
NOUN_RUOKO	uoko stem, uoko : uo’o variations
NOUN_RUUHI	i stem, i : e variations back harmony
NOUN_RUUMIS	is stem, is : ii variations back harmony
NOUN_RUUVI	i stem, i : e variations back harmony
NOUN_RYNNÄS	nnäs stem, nnäs : ntää variations
NOUN_RYNTTYYT	Plurale tantums, ttyyt stem, ttyyt : tys variations
NOUN_RYNTÄÄT	Plurale tantums, ntäät stem, ntäät : nnäs variatinos
NOUN_RYPÄS	päs stem, päs : ppää variations
NOUN_RYYPPY	ppy stem, ppy : py variations
NOUN_RÄJÄYTYS	s stem, s : kse variation front harmony
NOUN_RÄMEET	Plurale tantums, eet stem, e : ee variations, front harmony
NOUN_RÄMIÄT	Plurale tantums, iät stem, iät : iä variaitons
NOUN_SAAPAS	pas stem, pas : ppaa variations
NOUN_SAKSET	et stem, et : i variations
NOUN_SALPA	pa stem, pa : va variations
NOUN_SAMPI	mpi stem, mpi : mme variations back harmony
NOUN_SAMPO	mpo stem, mpo : mmo variations
NOUN_SANKARI	i stem, i : e variations and consonant stem ta partitive
NOUN_SAVI	i stems, i : e and i: 0 variations both, back
NOUN_SEIKKAILU	u stem no variations
NOUN_SEIVÄS	väs stems, väs : pää variations
NOUN_SEPPÄ	ppä stems, ppä : p variations
NOUN_SERKUKSET	Plurale tantums, kset stem, kset : s variations
NOUN_SHOW	consonant stem, ’ inflections
NOUN_SIEMEN	consonant stem, x : xe variations front harmony
NOUN_SIIRTO	rto stem, rto : rro variatnons
NOUN_SIIVILÄ	ä stem, ä : ö variations
NOUN_SILAKAT	Plurale tantums, kat stem, kat : kko variations
NOUN_SISÄLTÖ	ltö stem, ltö : llö variations
NOUN_SIVELLIN	llin stem, llin : ltime variations front harmony
NOUN_SIVISTYNYT	yt stem, yt : ee variations, mostly participles
NOUN_SKEITTI	tti stem, tti : te variations, front harmony
NOUN_SOINTI	nti stem, nti : nne variations
NOUN_SOKEA	ea stem, ea : e variations, mostly adjectives compounded or lexicalised 
NOUN_SOTA	ta stem, ta : d variations
NOUN_STADION	consnonant stem, X : xe variations back harmony
NOUN_SUHTEET	Plurale tantums, teet stem, teet :de variations back harmony
NOUN_SUKAT	Plurale tantums, kat stem, kat : kk variatons
NOUN_SULKA	ka stem, ka : 0 variations
NOUN_SUODATIN	tin stem, tin : ttime variations back harmony
NOUN_SUOMALAINEN	Nouns / adjectives, nen stem, nen : se variation
NOUN_SYDÄN	Nouns eith dän stem, n : me variations and dän : dämme : täme 
NOUN_SYLI	i stem, i : e variations and extra consonant stem stufff
NOUN_SYLTÄ	ltä stem, ltä : llä variations
NOUN_SYNNYTTIMET	Plurale tantums, timet stem, timet : tin variations front harmony
NOUN_SYÖMINGIT	Plurale tantums, ngit stem, ngit : nki variations
NOUN_SÄEN	en stem, en : kene variations
NOUN_SÄNKY	nky stem, nky : ngy variations
NOUN_SÄRKÄT	Plurale tantums, ät stem, kät:kk variations
NOUN_SÄRVIN	vin stem, vin : pime variations front harmony
NOUN_SÄÄDIN	din stem, din : time variations and front harmony
NOUN_SÄÄNNÖT	Plurale tantums, nnöt stem, nnöt : ntö variations
NOUN_SÄÄRET	Plurale tantums, i:e variation
NOUN_TAIMI	mi stem, mi : n variations back harmony
NOUN_TAIVAL	val stem, val : pale : palee variations
NOUN_HEVEN	ven stem, ven : pene : penee variations
NOUN_TALKOOT	Plurale tantums, oot stem, oot : o variations
NOUN_TALO	o stems, no variations
NOUN_TANHUA	a stems, a : o : 0 variations
NOUN_TARPEET	Plurale tantums, peet stem, peet : ve variations and back harmony
NOUN_TARVE	ve stems, ve : pe variations back harmony
NOUN_TAUDIT	Plurale tantums, dit stem, dit : ti variations back harmony
NOUN_TAUTI	ti stem, ti : de variations back harmony
NOUN_TAVAT	plurale tantums, vat stem, vat : pa variations
NOUN_TEE	ee stem, ee : e variations
NOUN_TEHDAS	das stem, das : taa variations
NOUN_TEKO	ko stem, ko : o : ’o variations
NOUN_TIE	ie stem, ie : e variation
NOUN_TIENOO	oo stem, oo : o variations
NOUN_TIET	Plurale tantums, iet stem, iet : ie : e variations
NOUN_TIETEET	Plurale tantums, teet stem, teet : de variations
NOUN_TIKKAAT	Plurale tantums, kaat steem, kaat : kas variations
NOUN_TIKKU	ku stem, kku : ku variations
NOUN_TIPPA	pa stem, ppa : po variations
NOUN_TOIMET	Plurale tantums, met stem, met : mi variations
NOUN_TOKEE	ee stem, ee : e variations
NOUN_TONGIT	ngit stem, ngit : nki variations
NOUN_TORTTU	ttu stem, ttu : tu variations
NOUN_TRIKOO	oo stem, oo : o variations
NOUN_TUHKA	hka stem, hka : h ~ hk variations
NOUN_TULI	i stem, i : e variations back harmony
NOUN_TUNNIT	nnit stem, nnit : nti variations baack harmony
NOUN_TUNTO	nto stem, nto : nnot variations 
NOUN_TUOMIO	o stem no variations
NOUN_TYPPI	ppi stem, ppi : pe variations
NOUN_TYTÄR	tär stem, tär : ttäre variations
NOUN_TYTÖT	Plurale tantums, töt stems, töt : ttö variations
NOUN_TYYLI	i stems, i : e variations front harmony
NOUN_TYYPPI	ppi stem, ppi : pe variations front harmony
NOUN_TYÖ	yö stem, yö : ö variatons
NOUN_TYÖT	Plurale tantums, yöt stem, yöt : yö : ö variations
NOUN_TÖRPPÖ	ppö stem, ppö : pö variations
NOUN_UDAR	dar stem, dar : taree variations
NOUN_ÄVÄR	vär stem, vär : päree variations
NOUN_UKKO	kko stem, kko : ko variations
NOUN_UKSI	ksi stem, ksi : s variations
NOUN_ULAPPA	ppa stem, ppa : po variations
NOUN_UROS	s stem, s : kse ~ o variations
NOUN_VAADIN	din stem, din : time variations
NOUN_VAAKA	aka stem, aka : a’ variations
NOUN_VAATTEET	Plurale tantums, teet stem, tteet: te variations
NOUN_VAINAA	aa stem, aa : a variations
NOUN_VAKUUTUS	s stem, s : ks variations back harmony
NOUN_VALJAAT	Plurale tantums, aat stem, aat : as variation
NOUN_VALLAT	Plurale tantums, llat stem, llat : lta variations
NOUN_VALTA	lta stem, lta : lla variations
NOUN_VANHEMMAT	PLurale tantums, mmat, mmat : mp variations
NOUN_VANHEMPI	mpi stem, mpi : mma variations
NOUN_VANKI	nki stem, nki : nge variations back harmony
NOUN_VANTTUUT	Plurale tantums, ttuut stem, ttuut : tus variations
NOUN_VANTUS	tus stem, tus : ttuu variations
NOUN_VARAS	as stem, as : kaa variatons
NOUN_VARAT	PLurale tantums, at stem, at : o variations
NOUN_VARSI	rsi stem, rsi : rre variations
NOUN_VARVAS	vas stem, vas : paa variations
NOUN_VASEN	n stem, n : mma variations
NOUN_VEHKEILY	y stem, no variations
NOUN_VEITSI	tsi stem, tsi : s variations front harmony
NOUN_VELI	veli stem, li : lj variations
NOUN_VEMMEL	mmel stem, mmel : mpelee variations
NOUN_VERI	veri stem, i : e variations and tä partitive
NOUN_VETIMET	Plurale tantums, timet stem, timet : din variations
NOUN_VETO	to stem, to : do variations
NOUN_VETY	ty stem, ty : dy variations
NOUN_VIENTI	nti stem, nti : nni variations front harmony
NOUN_VIHKIÄISET	Plurale tantums, set stem, set : nen harmony front harmony
NOUN_VIHKO	hko stem, hko : h ~ hk variations
NOUN_VIIVE	ve stem, ve : pe variations front harmony
NOUN_VIKA	ka stem, ka : o variations
NOUN_VINKU	nku stem, nku : ngu varitioant
NOUN_VIRRET	rret stem, rret : rs variations
NOUN_VIRSI	rsi stem, rsi : rre variations
NOUN_VOIMA	a stem, a : 0 variations
NOUN_VUO	uo stem, uo : o ariationt
NOUN_VUODET	Plurale tantums, det stem, det :si variations back harmony
NOUN_VUOLLE	lle stem, lle : ltee variaotns back harmonu
NOUN_VUOSITUHAT	tuhat stem, t : nne variations usually from compounded 1000s
NOUN_YHTIÖT	Plurale tantum, iö stem, no varitionst
NOUN_YKSIKKÖ	kkö stem, kkö : kö variations
NOUN_YLEIS-	Bound nominal stems, that require compounding or hyphen
NOUN_YLKÄ	kä stems, kä : 0 variations
NOUN_YLÄNKÖ	nkö stem, nkö : ngö variations
NOUN_YMPÄRYSTÄ	ä stem, ä : 0 variations
NOUN_YSTÄVYKSET	Plurale tantums, kset stem, kset : s variations front harmony
NOUN_YÖKKÖ	kö stem, kkö : kö variations
NOUN_ZEN	consonant stem, X : Xe variations front harmony
NOUN_DESIGN	consonant stem, X : Xe variations both harmonies
NOUN_ZOMBIE	ie stem, no variations back harmony
NOUN_ÄYRÄS	äs stem, äs : ää variations
NUM_51kahdeksanbiljardia	Optimisation hack for exceptional compound ’kahdeksanbiljardia’
NUM_51kahdeksanbiljoonaa	Optimisation hack for exceptional compound ’kahdeksanbiljoonaa’
NUM_51kahdeksandekiljardia	Optimisation hack for exceptional compound ’kahdeksandekiljardia’
NUM_51kahdeksandekiljoonaa	Optimisation hack for exceptional compound ’kahdeksandekiljoonaa’
NUM_51kahdeksanduodekiljardia	Optimisation hack for exceptional compound ’kahdeksanduodekiljardia’
NUM_51kahdeksanduodekiljoonaa	Optimisation hack for exceptional compound ’kahdeksanduodekiljoonaa’
NUM_51kahdeksankahdeksatta	Optimisation hack for exceptional compound ’kahdeksankahdeksatta’
NUM_51kahdeksankiljardia	Optimisation hack for exceptional compound ’kahdeksankiljardia’
NUM_51kahdeksankiljoonaa	Optimisation hack for exceptional compound ’kahdeksankiljoonaa’
NUM_51kahdeksankolmatta	Optimisation hack for exceptional compound ’kahdeksankolmatta’
NUM_51kahdeksankuudetta	Optimisation hack for exceptional compound ’kahdeksankuudetta’
NUM_51kahdeksankvadriljardia	Optimisation hack for exceptional compound ’kahdeksankvadriljardia’
NUM_51kahdeksankvadriljoonaa	Optimisation hack for exceptional compound ’kahdeksankvadriljoonaa’
NUM_51kahdeksankvintiljardia	Optimisation hack for exceptional compound ’kahdeksankvintiljardia’
NUM_51kahdeksankvintiljoonaa	Optimisation hack for exceptional compound ’kahdeksankvintiljoonaa’
NUM_51kahdeksankymmentä	Optimisation hack for exceptional compound ’kahdeksankymmentä’
NUM_51kahdeksanmiljardia	Optimisation hack for exceptional compound ’kahdeksanmiljardia’
NUM_51kahdeksanmiljoonaa	Optimisation hack for exceptional compound ’kahdeksanmiljoonaa’
NUM_51kahdeksanneljättä	Optimisation hack for exceptional compound ’kahdeksanneljättä’
NUM_51kahdeksannoniljardia	Optimisation hack for exceptional compound ’kahdeksannoniljardia’
NUM_51kahdeksannoniljoonaa	Optimisation hack for exceptional compound ’kahdeksannoniljoonaa’
NUM_51kahdeksanoktiljardia	Optimisation hack for exceptional compound ’kahdeksanoktiljardia’
NUM_51kahdeksanoktiljoonaa	Optimisation hack for exceptional compound ’kahdeksanoktiljoonaa’
NUM_51kahdeksanpiljardia	Optimisation hack for exceptional compound ’kahdeksanpiljardia’
NUM_51kahdeksanpiljoonaa	Optimisation hack for exceptional compound ’kahdeksanpiljoonaa’
NUM_51kahdeksansataa	Optimisation hack for exceptional compound ’kahdeksansataa’
NUM_51kahdeksanseitsemättä	Optimisation hack for exceptional compound ’kahdeksanseitsemättä’
NUM_51kahdeksansentiljardia	Optimisation hack for exceptional compound ’kahdeksansentiljardia’
NUM_51kahdeksansentiljoonaa	Optimisation hack for exceptional compound ’kahdeksansentiljoonaa’
NUM_51kahdeksanseptiljardia	Optimisation hack for exceptional compound ’kahdeksanseptiljardia’
NUM_51kahdeksanseptiljoonaa	Optimisation hack for exceptional compound ’kahdeksanseptiljoonaa’
NUM_51kahdeksantoista	Optimisation hack for exceptional compound ’kahdeksantoista’
NUM_51kahdeksantredekiljardia	Optimisation hack for exceptional compound ’kahdeksantredekiljardia’
NUM_51kahdeksantredekiljoonaa	Optimisation hack for exceptional compound ’kahdeksantredekiljoonaa’
NUM_51kahdeksantriljardia	Optimisation hack for exceptional compound ’kahdeksantriljardia’
NUM_51kahdeksantriljoonaa	Optimisation hack for exceptional compound ’kahdeksantriljoonaa’
NUM_51kahdeksantsiljardia	Optimisation hack for exceptional compound ’kahdeksantsiljardia’
NUM_51kahdeksantsiljoonaa	Optimisation hack for exceptional compound ’kahdeksantsiljoonaa’
NUM_51kahdeksantuhatta	Optimisation hack for exceptional compound ’kahdeksantuhatta’
NUM_51kahdeksanundekiljardia	Optimisation hack for exceptional compound ’kahdeksanundekiljardia’
NUM_51kahdeksanundekiljoonaa	Optimisation hack for exceptional compound ’kahdeksanundekiljoonaa’
NUM_51kahdeksanviidettä	Optimisation hack for exceptional compound ’kahdeksanviidettä’
NUM_51kahdeksanyhdeksättä	Optimisation hack for exceptional compound ’kahdeksanyhdeksättä’
NUM_51kahdeksasbiljardis	Optimisation hack for exceptional compound ’kahdeksasbiljardis’
NUM_51kahdeksasbiljoonas	Optimisation hack for exceptional compound ’kahdeksasbiljoonas’
NUM_51kahdeksasdekiljardis	Optimisation hack for exceptional compound ’kahdeksasdekiljardis’
NUM_51kahdeksasdekiljoonas	Optimisation hack for exceptional compound ’kahdeksasdekiljoonas’
NUM_51kahdeksasduodekiljardis	Optimisation hack for exceptional compound ’kahdeksasduodekiljardis’
NUM_51kahdeksasduodekiljoonas	Optimisation hack for exceptional compound ’kahdeksasduodekiljoonas’
NUM_51kahdeksaskahdeksatta	Optimisation hack for exceptional compound ’kahdeksaskahdeksatta’
NUM_51kahdeksaskiljardis	Optimisation hack for exceptional compound ’kahdeksaskiljardis’
NUM_51kahdeksaskiljoonas	Optimisation hack for exceptional compound ’kahdeksaskiljoonas’
NUM_51kahdeksaskolmatta	Optimisation hack for exceptional compound ’kahdeksaskolmatta’
NUM_51kahdeksaskuudetta	Optimisation hack for exceptional compound ’kahdeksaskuudetta’
NUM_51kahdeksaskvadriljardis	Optimisation hack for exceptional compound ’kahdeksaskvadriljardis’
NUM_51kahdeksaskvadriljoonas	Optimisation hack for exceptional compound ’kahdeksaskvadriljoonas’
NUM_51kahdeksaskvintiljardis	Optimisation hack for exceptional compound ’kahdeksaskvintiljardis’
NUM_51kahdeksaskvintiljoonas	Optimisation hack for exceptional compound ’kahdeksaskvintiljoonas’
NUM_51kahdeksaskymmenes	Optimisation hack for exceptional compound ’kahdeksaskymmenes’
NUM_51kahdeksasmiljardis	Optimisation hack for exceptional compound ’kahdeksasmiljardis’
NUM_51kahdeksasmiljoonas	Optimisation hack for exceptional compound ’kahdeksasmiljoonas’
NUM_51kahdeksasneljättä	Optimisation hack for exceptional compound ’kahdeksasneljättä’
NUM_51kahdeksasnoniljardis	Optimisation hack for exceptional compound ’kahdeksasnoniljardis’
NUM_51kahdeksasnoniljoonas	Optimisation hack for exceptional compound ’kahdeksasnoniljoonas’
NUM_51kahdeksasoktiljardis	Optimisation hack for exceptional compound ’kahdeksasoktiljardis’
NUM_51kahdeksasoktiljoonas	Optimisation hack for exceptional compound ’kahdeksasoktiljoonas’
NUM_51kahdeksaspiljardis	Optimisation hack for exceptional compound ’kahdeksaspiljardis’
NUM_51kahdeksaspiljoonas	Optimisation hack for exceptional compound ’kahdeksaspiljoonas’
NUM_51kahdeksassadas	Optimisation hack for exceptional compound ’kahdeksassadas’
NUM_51kahdeksasseitsemättä	Optimisation hack for exceptional compound ’kahdeksasseitsemättä’
NUM_51kahdeksassentiljardis	Optimisation hack for exceptional compound ’kahdeksassentiljardis’
NUM_51kahdeksassentiljoonas	Optimisation hack for exceptional compound ’kahdeksassentiljoonas’
NUM_51kahdeksasseptiljardis	Optimisation hack for exceptional compound ’kahdeksasseptiljardis’
NUM_51kahdeksasseptiljoonas	Optimisation hack for exceptional compound ’kahdeksasseptiljoonas’
NUM_51kahdeksastoista	Optimisation hack for exceptional compound ’kahdeksastoista’
NUM_51kahdeksastredekiljardis	Optimisation hack for exceptional compound ’kahdeksastredekiljardis’
NUM_51kahdeksastredekiljoonas	Optimisation hack for exceptional compound ’kahdeksastredekiljoonas’
NUM_51kahdeksastriljardis	Optimisation hack for exceptional compound ’kahdeksastriljardis’
NUM_51kahdeksastriljoonas	Optimisation hack for exceptional compound ’kahdeksastriljoonas’
NUM_51kahdeksastsiljardis	Optimisation hack for exceptional compound ’kahdeksastsiljardis’
NUM_51kahdeksastsiljoonas	Optimisation hack for exceptional compound ’kahdeksastsiljoonas’
NUM_51kahdeksastuhannes	Optimisation hack for exceptional compound ’kahdeksastuhannes’
NUM_51kahdeksasundekiljardis	Optimisation hack for exceptional compound ’kahdeksasundekiljardis’
NUM_51kahdeksasundekiljoonas	Optimisation hack for exceptional compound ’kahdeksasundekiljoonas’
NUM_51kahdeksasviidettä	Optimisation hack for exceptional compound ’kahdeksasviidettä’
NUM_51kahdeksasyhdeksättä	Optimisation hack for exceptional compound ’kahdeksasyhdeksättä’
NUM_51kahdesbiljardis	Optimisation hack for exceptional compound ’kahdesbiljardis’
NUM_51kahdesbiljoonas	Optimisation hack for exceptional compound ’kahdesbiljoonas’
NUM_51kahdesdekiljardis	Optimisation hack for exceptional compound ’kahdesdekiljardis’
NUM_51kahdesdekiljoonas	Optimisation hack for exceptional compound ’kahdesdekiljoonas’
NUM_51kahdesduodekiljardis	Optimisation hack for exceptional compound ’kahdesduodekiljardis’
NUM_51kahdesduodekiljoonas	Optimisation hack for exceptional compound ’kahdesduodekiljoonas’
NUM_51kahdeskahdeksatta	Optimisation hack for exceptional compound ’kahdeskahdeksatta’
NUM_51kahdeskiljardis	Optimisation hack for exceptional compound ’kahdeskiljardis’
NUM_51kahdeskiljoonas	Optimisation hack for exceptional compound ’kahdeskiljoonas’
NUM_51kahdeskolmatta	Optimisation hack for exceptional compound ’kahdeskolmatta’
NUM_51kahdeskuudetta	Optimisation hack for exceptional compound ’kahdeskuudetta’
NUM_51kahdeskvadriljardis	Optimisation hack for exceptional compound ’kahdeskvadriljardis’
NUM_51kahdeskvadriljoonas	Optimisation hack for exceptional compound ’kahdeskvadriljoonas’
NUM_51kahdeskvintiljardis	Optimisation hack for exceptional compound ’kahdeskvintiljardis’
NUM_51kahdeskvintiljoonas	Optimisation hack for exceptional compound ’kahdeskvintiljoonas’
NUM_51kahdeskymmenes	Optimisation hack for exceptional compound ’kahdeskymmenes’
NUM_51kahdesmiljardis	Optimisation hack for exceptional compound ’kahdesmiljardis’
NUM_51kahdesmiljoonas	Optimisation hack for exceptional compound ’kahdesmiljoonas’
NUM_51kahdesneljättä	Optimisation hack for exceptional compound ’kahdesneljättä’
NUM_51kahdesnoniljardis	Optimisation hack for exceptional compound ’kahdesnoniljardis’
NUM_51kahdesnoniljoonas	Optimisation hack for exceptional compound ’kahdesnoniljoonas’
NUM_51kahdesoktiljardis	Optimisation hack for exceptional compound ’kahdesoktiljardis’
NUM_51kahdesoktiljoonas	Optimisation hack for exceptional compound ’kahdesoktiljoonas’
NUM_51kahdespiljardis	Optimisation hack for exceptional compound ’kahdespiljardis’
NUM_51kahdespiljoonas	Optimisation hack for exceptional compound ’kahdespiljoonas’
NUM_51kahdessadas	Optimisation hack for exceptional compound ’kahdessadas’
NUM_51kahdesseitsemättä	Optimisation hack for exceptional compound ’kahdesseitsemättä’
NUM_51kahdessentiljardis	Optimisation hack for exceptional compound ’kahdessentiljardis’
NUM_51kahdessentiljoonas	Optimisation hack for exceptional compound ’kahdessentiljoonas’
NUM_51kahdesseptiljardis	Optimisation hack for exceptional compound ’kahdesseptiljardis’
NUM_51kahdesseptiljoonas	Optimisation hack for exceptional compound ’kahdesseptiljoonas’
NUM_51kahdestoista	Optimisation hack for exceptional compound ’kahdestoista’
NUM_51kahdestredekiljardis	Optimisation hack for exceptional compound ’kahdestredekiljardis’
NUM_51kahdestredekiljoonas	Optimisation hack for exceptional compound ’kahdestredekiljoonas’
NUM_51kahdestriljardis	Optimisation hack for exceptional compound ’kahdestriljardis’
NUM_51kahdestriljoonas	Optimisation hack for exceptional compound ’kahdestriljoonas’
NUM_51kahdestsiljardis	Optimisation hack for exceptional compound ’kahdestsiljardis’
NUM_51kahdestsiljoonas	Optimisation hack for exceptional compound ’kahdestsiljoonas’
NUM_51kahdestuhannes	Optimisation hack for exceptional compound ’kahdestuhannes’
NUM_51kahdesundekiljardis	Optimisation hack for exceptional compound ’kahdesundekiljardis’
NUM_51kahdesundekiljoonas	Optimisation hack for exceptional compound ’kahdesundekiljoonas’
NUM_51kahdesviidettä	Optimisation hack for exceptional compound ’kahdesviidettä’
NUM_51kahdesyhdeksättä	Optimisation hack for exceptional compound ’kahdesyhdeksättä’
NUM_51kaksibiljardia	Optimisation hack for exceptional compound ’kaksibiljardia’
NUM_51kaksibiljoonaa	Optimisation hack for exceptional compound ’kaksibiljoonaa’
NUM_51kaksidekiljardia	Optimisation hack for exceptional compound ’kaksidekiljardia’
NUM_51kaksidekiljoonaa	Optimisation hack for exceptional compound ’kaksidekiljoonaa’
NUM_51kaksiduodekiljardia	Optimisation hack for exceptional compound ’kaksiduodekiljardia’
NUM_51kaksiduodekiljoonaa	Optimisation hack for exceptional compound ’kaksiduodekiljoonaa’
NUM_51kaksikahdeksatta	Optimisation hack for exceptional compound ’kaksikahdeksatta’
NUM_51kaksikiljardia	Optimisation hack for exceptional compound ’kaksikiljardia’
NUM_51kaksikiljoonaa	Optimisation hack for exceptional compound ’kaksikiljoonaa’
NUM_51kaksikolmatta	Optimisation hack for exceptional compound ’kaksikolmatta’
NUM_51kaksikuudetta	Optimisation hack for exceptional compound ’kaksikuudetta’
NUM_51kaksikvadriljardia	Optimisation hack for exceptional compound ’kaksikvadriljardia’
NUM_51kaksikvadriljoonaa	Optimisation hack for exceptional compound ’kaksikvadriljoonaa’
NUM_51kaksikvintiljardia	Optimisation hack for exceptional compound ’kaksikvintiljardia’
NUM_51kaksikvintiljoonaa	Optimisation hack for exceptional compound ’kaksikvintiljoonaa’
NUM_51kaksikymmentä	Optimisation hack for exceptional compound ’kaksikymmentä’
NUM_51kaksimiljardia	Optimisation hack for exceptional compound ’kaksimiljardia’
NUM_51kaksimiljoonaa	Optimisation hack for exceptional compound ’kaksimiljoonaa’
NUM_51kaksineljättä	Optimisation hack for exceptional compound ’kaksineljättä’
NUM_51kaksinoniljardia	Optimisation hack for exceptional compound ’kaksinoniljardia’
NUM_51kaksinoniljoonaa	Optimisation hack for exceptional compound ’kaksinoniljoonaa’
NUM_51kaksioktiljardia	Optimisation hack for exceptional compound ’kaksioktiljardia’
NUM_51kaksioktiljoonaa	Optimisation hack for exceptional compound ’kaksioktiljoonaa’
NUM_51kaksipiljardia	Optimisation hack for exceptional compound ’kaksipiljardia’
NUM_51kaksipiljoonaa	Optimisation hack for exceptional compound ’kaksipiljoonaa’
NUM_51kaksisataa	Optimisation hack for exceptional compound ’kaksisataa’
NUM_51kaksiseitsemättä	Optimisation hack for exceptional compound ’kaksiseitsemättä’
NUM_51kaksisentiljardia	Optimisation hack for exceptional compound ’kaksisentiljardia’
NUM_51kaksisentiljoonaa	Optimisation hack for exceptional compound ’kaksisentiljoonaa’
NUM_51kaksiseptiljardia	Optimisation hack for exceptional compound ’kaksiseptiljardia’
NUM_51kaksiseptiljoonaa	Optimisation hack for exceptional compound ’kaksiseptiljoonaa’
NUM_51kaksitoista	Optimisation hack for exceptional compound ’kaksitoista’
NUM_51kaksitredekiljardia	Optimisation hack for exceptional compound ’kaksitredekiljardia’
NUM_51kaksitredekiljoonaa	Optimisation hack for exceptional compound ’kaksitredekiljoonaa’
NUM_51kaksitriljardia	Optimisation hack for exceptional compound ’kaksitriljardia’
NUM_51kaksitriljoonaa	Optimisation hack for exceptional compound ’kaksitriljoonaa’
NUM_51kaksitsiljardia	Optimisation hack for exceptional compound ’kaksitsiljardia’
NUM_51kaksitsiljoonaa	Optimisation hack for exceptional compound ’kaksitsiljoonaa’
NUM_51kaksituhatta	Optimisation hack for exceptional compound ’kaksituhatta’
NUM_51kaksiundekiljardia	Optimisation hack for exceptional compound ’kaksiundekiljardia’
NUM_51kaksiundekiljoonaa	Optimisation hack for exceptional compound ’kaksiundekiljoonaa’
NUM_51kaksiviidettä	Optimisation hack for exceptional compound ’kaksiviidettä’
NUM_51kaksiyhdeksättä	Optimisation hack for exceptional compound ’kaksiyhdeksättä’
NUM_51kolmasbiljardis	Optimisation hack for exceptional compound ’kolmasbiljardis’
NUM_51kolmasbiljoonas	Optimisation hack for exceptional compound ’kolmasbiljoonas’
NUM_51kolmasdekiljardis	Optimisation hack for exceptional compound ’kolmasdekiljardis’
NUM_51kolmasdekiljoonas	Optimisation hack for exceptional compound ’kolmasdekiljoonas’
NUM_51kolmasduodekiljardis	Optimisation hack for exceptional compound ’kolmasduodekiljardis’
NUM_51kolmasduodekiljoonas	Optimisation hack for exceptional compound ’kolmasduodekiljoonas’
NUM_51kolmaskahdeksatta	Optimisation hack for exceptional compound ’kolmaskahdeksatta’
NUM_51kolmaskiljardis	Optimisation hack for exceptional compound ’kolmaskiljardis’
NUM_51kolmaskiljoonas	Optimisation hack for exceptional compound ’kolmaskiljoonas’
NUM_51kolmaskolmatta	Optimisation hack for exceptional compound ’kolmaskolmatta’
NUM_51kolmaskuudetta	Optimisation hack for exceptional compound ’kolmaskuudetta’
NUM_51kolmaskvadriljardis	Optimisation hack for exceptional compound ’kolmaskvadriljardis’
NUM_51kolmaskvadriljoonas	Optimisation hack for exceptional compound ’kolmaskvadriljoonas’
NUM_51kolmaskvintiljardis	Optimisation hack for exceptional compound ’kolmaskvintiljardis’
NUM_51kolmaskvintiljoonas	Optimisation hack for exceptional compound ’kolmaskvintiljoonas’
NUM_51kolmaskymmenes	Optimisation hack for exceptional compound ’kolmaskymmenes’
NUM_51kolmasmiljardis	Optimisation hack for exceptional compound ’kolmasmiljardis’
NUM_51kolmasmiljoonas	Optimisation hack for exceptional compound ’kolmasmiljoonas’
NUM_51kolmasneljättä	Optimisation hack for exceptional compound ’kolmasneljättä’
NUM_51kolmasnoniljardis	Optimisation hack for exceptional compound ’kolmasnoniljardis’
NUM_51kolmasnoniljoonas	Optimisation hack for exceptional compound ’kolmasnoniljoonas’
NUM_51kolmasoktiljardis	Optimisation hack for exceptional compound ’kolmasoktiljardis’
NUM_51kolmasoktiljoonas	Optimisation hack for exceptional compound ’kolmasoktiljoonas’
NUM_51kolmaspiljardis	Optimisation hack for exceptional compound ’kolmaspiljardis’
NUM_51kolmaspiljoonas	Optimisation hack for exceptional compound ’kolmaspiljoonas’
NUM_51kolmassadas	Optimisation hack for exceptional compound ’kolmassadas’
NUM_51kolmasseitsemättä	Optimisation hack for exceptional compound ’kolmasseitsemättä’
NUM_51kolmassentiljardis	Optimisation hack for exceptional compound ’kolmassentiljardis’
NUM_51kolmassentiljoonas	Optimisation hack for exceptional compound ’kolmassentiljoonas’
NUM_51kolmasseptiljardis	Optimisation hack for exceptional compound ’kolmasseptiljardis’
NUM_51kolmasseptiljoonas	Optimisation hack for exceptional compound ’kolmasseptiljoonas’
NUM_51kolmastoista	Optimisation hack for exceptional compound ’kolmastoista’
NUM_51kolmastredekiljardis	Optimisation hack for exceptional compound ’kolmastredekiljardis’
NUM_51kolmastredekiljoonas	Optimisation hack for exceptional compound ’kolmastredekiljoonas’
NUM_51kolmastriljardis	Optimisation hack for exceptional compound ’kolmastriljardis’
NUM_51kolmastriljoonas	Optimisation hack for exceptional compound ’kolmastriljoonas’
NUM_51kolmastsiljardis	Optimisation hack for exceptional compound ’kolmastsiljardis’
NUM_51kolmastsiljoonas	Optimisation hack for exceptional compound ’kolmastsiljoonas’
NUM_51kolmastuhannes	Optimisation hack for exceptional compound ’kolmastuhannes’
NUM_51kolmasundekiljardis	Optimisation hack for exceptional compound ’kolmasundekiljardis’
NUM_51kolmasundekiljoonas	Optimisation hack for exceptional compound ’kolmasundekiljoonas’
NUM_51kolmasviidettä	Optimisation hack for exceptional compound ’kolmasviidettä’
NUM_51kolmasyhdeksättä	Optimisation hack for exceptional compound ’kolmasyhdeksättä’
NUM_51kolmebiljardia	Optimisation hack for exceptional compound ’kolmebiljardia’
NUM_51kolmebiljoonaa	Optimisation hack for exceptional compound ’kolmebiljoonaa’
NUM_51kolmedekiljardia	Optimisation hack for exceptional compound ’kolmedekiljardia’
NUM_51kolmedekiljoonaa	Optimisation hack for exceptional compound ’kolmedekiljoonaa’
NUM_51kolmeduodekiljardia	Optimisation hack for exceptional compound ’kolmeduodekiljardia’
NUM_51kolmeduodekiljoonaa	Optimisation hack for exceptional compound ’kolmeduodekiljoonaa’
NUM_51kolmekahdeksatta	Optimisation hack for exceptional compound ’kolmekahdeksatta’
NUM_51kolmekiljardia	Optimisation hack for exceptional compound ’kolmekiljardia’
NUM_51kolmekiljoonaa	Optimisation hack for exceptional compound ’kolmekiljoonaa’
NUM_51kolmekolmatta	Optimisation hack for exceptional compound ’kolmekolmatta’
NUM_51kolmekuudetta	Optimisation hack for exceptional compound ’kolmekuudetta’
NUM_51kolmekvadriljardia	Optimisation hack for exceptional compound ’kolmekvadriljardia’
NUM_51kolmekvadriljoonaa	Optimisation hack for exceptional compound ’kolmekvadriljoonaa’
NUM_51kolmekvintiljardia	Optimisation hack for exceptional compound ’kolmekvintiljardia’
NUM_51kolmekvintiljoonaa	Optimisation hack for exceptional compound ’kolmekvintiljoonaa’
NUM_51kolmekymmentä	Optimisation hack for exceptional compound ’kolmekymmentä’
NUM_51kolmemiljardia	Optimisation hack for exceptional compound ’kolmemiljardia’
NUM_51kolmemiljoonaa	Optimisation hack for exceptional compound ’kolmemiljoonaa’
NUM_51kolmeneljättä	Optimisation hack for exceptional compound ’kolmeneljättä’
NUM_51kolmenoniljardia	Optimisation hack for exceptional compound ’kolmenoniljardia’
NUM_51kolmenoniljoonaa	Optimisation hack for exceptional compound ’kolmenoniljoonaa’
NUM_51kolmeoktiljardia	Optimisation hack for exceptional compound ’kolmeoktiljardia’
NUM_51kolmeoktiljoonaa	Optimisation hack for exceptional compound ’kolmeoktiljoonaa’
NUM_51kolmepiljardia	Optimisation hack for exceptional compound ’kolmepiljardia’
NUM_51kolmepiljoonaa	Optimisation hack for exceptional compound ’kolmepiljoonaa’
NUM_51kolmesataa	Optimisation hack for exceptional compound ’kolmesataa’
NUM_51kolmeseitsemättä	Optimisation hack for exceptional compound ’kolmeseitsemättä’
NUM_51kolmesentiljardia	Optimisation hack for exceptional compound ’kolmesentiljardia’
NUM_51kolmesentiljoonaa	Optimisation hack for exceptional compound ’kolmesentiljoonaa’
NUM_51kolmeseptiljardia	Optimisation hack for exceptional compound ’kolmeseptiljardia’
NUM_51kolmeseptiljoonaa	Optimisation hack for exceptional compound ’kolmeseptiljoonaa’
NUM_51kolmetoista	Optimisation hack for exceptional compound ’kolmetoista’
NUM_51kolmetredekiljardia	Optimisation hack for exceptional compound ’kolmetredekiljardia’
NUM_51kolmetredekiljoonaa	Optimisation hack for exceptional compound ’kolmetredekiljoonaa’
NUM_51kolmetriljardia	Optimisation hack for exceptional compound ’kolmetriljardia’
NUM_51kolmetriljoonaa	Optimisation hack for exceptional compound ’kolmetriljoonaa’
NUM_51kolmetsiljardia	Optimisation hack for exceptional compound ’kolmetsiljardia’
NUM_51kolmetsiljoonaa	Optimisation hack for exceptional compound ’kolmetsiljoonaa’
NUM_51kolmetuhatta	Optimisation hack for exceptional compound ’kolmetuhatta’
NUM_51kolmeundekiljardia	Optimisation hack for exceptional compound ’kolmeundekiljardia’
NUM_51kolmeundekiljoonaa	Optimisation hack for exceptional compound ’kolmeundekiljoonaa’
NUM_51kolmeviidettä	Optimisation hack for exceptional compound ’kolmeviidettä’
NUM_51kolmeyhdeksättä	Optimisation hack for exceptional compound ’kolmeyhdeksättä’
NUM_51kuudesbiljardis	Optimisation hack for exceptional compound ’kuudesbiljardis’
NUM_51kuudesbiljoonas	Optimisation hack for exceptional compound ’kuudesbiljoonas’
NUM_51kuudesdekiljardis	Optimisation hack for exceptional compound ’kuudesdekiljardis’
NUM_51kuudesdekiljoonas	Optimisation hack for exceptional compound ’kuudesdekiljoonas’
NUM_51kuudesduodekiljardis	Optimisation hack for exceptional compound ’kuudesduodekiljardis’
NUM_51kuudesduodekiljoonas	Optimisation hack for exceptional compound ’kuudesduodekiljoonas’
NUM_51kuudeskahdeksatta	Optimisation hack for exceptional compound ’kuudeskahdeksatta’
NUM_51kuudeskiljardis	Optimisation hack for exceptional compound ’kuudeskiljardis’
NUM_51kuudeskiljoonas	Optimisation hack for exceptional compound ’kuudeskiljoonas’
NUM_51kuudeskolmatta	Optimisation hack for exceptional compound ’kuudeskolmatta’
NUM_51kuudeskuudetta	Optimisation hack for exceptional compound ’kuudeskuudetta’
NUM_51kuudeskvadriljardis	Optimisation hack for exceptional compound ’kuudeskvadriljardis’
NUM_51kuudeskvadriljoonas	Optimisation hack for exceptional compound ’kuudeskvadriljoonas’
NUM_51kuudeskvintiljardis	Optimisation hack for exceptional compound ’kuudeskvintiljardis’
NUM_51kuudeskvintiljoonas	Optimisation hack for exceptional compound ’kuudeskvintiljoonas’
NUM_51kuudeskymmenes	Optimisation hack for exceptional compound ’kuudeskymmenes’
NUM_51kuudesmiljardis	Optimisation hack for exceptional compound ’kuudesmiljardis’
NUM_51kuudesmiljoonas	Optimisation hack for exceptional compound ’kuudesmiljoonas’
NUM_51kuudesneljättä	Optimisation hack for exceptional compound ’kuudesneljättä’
NUM_51kuudesnoniljardis	Optimisation hack for exceptional compound ’kuudesnoniljardis’
NUM_51kuudesnoniljoonas	Optimisation hack for exceptional compound ’kuudesnoniljoonas’
NUM_51kuudesoktiljardis	Optimisation hack for exceptional compound ’kuudesoktiljardis’
NUM_51kuudesoktiljoonas	Optimisation hack for exceptional compound ’kuudesoktiljoonas’
NUM_51kuudespiljardis	Optimisation hack for exceptional compound ’kuudespiljardis’
NUM_51kuudespiljoonas	Optimisation hack for exceptional compound ’kuudespiljoonas’
NUM_51kuudessadas	Optimisation hack for exceptional compound ’kuudessadas’
NUM_51kuudesseitsemättä	Optimisation hack for exceptional compound ’kuudesseitsemättä’
NUM_51kuudessentiljardis	Optimisation hack for exceptional compound ’kuudessentiljardis’
NUM_51kuudessentiljoonas	Optimisation hack for exceptional compound ’kuudessentiljoonas’
NUM_51kuudesseptiljardis	Optimisation hack for exceptional compound ’kuudesseptiljardis’
NUM_51kuudesseptiljoonas	Optimisation hack for exceptional compound ’kuudesseptiljoonas’
NUM_51kuudestoista	Optimisation hack for exceptional compound ’kuudestoista’
NUM_51kuudestredekiljardis	Optimisation hack for exceptional compound ’kuudestredekiljardis’
NUM_51kuudestredekiljoonas	Optimisation hack for exceptional compound ’kuudestredekiljoonas’
NUM_51kuudestriljardis	Optimisation hack for exceptional compound ’kuudestriljardis’
NUM_51kuudestriljoonas	Optimisation hack for exceptional compound ’kuudestriljoonas’
NUM_51kuudestsiljardis	Optimisation hack for exceptional compound ’kuudestsiljardis’
NUM_51kuudestsiljoonas	Optimisation hack for exceptional compound ’kuudestsiljoonas’
NUM_51kuudestuhannes	Optimisation hack for exceptional compound ’kuudestuhannes’
NUM_51kuudesundekiljardis	Optimisation hack for exceptional compound ’kuudesundekiljardis’
NUM_51kuudesundekiljoonas	Optimisation hack for exceptional compound ’kuudesundekiljoonas’
NUM_51kuudesviidettä	Optimisation hack for exceptional compound ’kuudesviidettä’
NUM_51kuudesyhdeksättä	Optimisation hack for exceptional compound ’kuudesyhdeksättä’
NUM_51kuusibiljardia	Optimisation hack for exceptional compound ’kuusibiljardia’
NUM_51kuusibiljoonaa	Optimisation hack for exceptional compound ’kuusibiljoonaa’
NUM_51kuusidekiljardia	Optimisation hack for exceptional compound ’kuusidekiljardia’
NUM_51kuusidekiljoonaa	Optimisation hack for exceptional compound ’kuusidekiljoonaa’
NUM_51kuusiduodekiljardia	Optimisation hack for exceptional compound ’kuusiduodekiljardia’
NUM_51kuusiduodekiljoonaa	Optimisation hack for exceptional compound ’kuusiduodekiljoonaa’
NUM_51kuusikahdeksatta	Optimisation hack for exceptional compound ’kuusikahdeksatta’
NUM_51kuusikiljardia	Optimisation hack for exceptional compound ’kuusikiljardia’
NUM_51kuusikiljoonaa	Optimisation hack for exceptional compound ’kuusikiljoonaa’
NUM_51kuusikolmatta	Optimisation hack for exceptional compound ’kuusikolmatta’
NUM_51kuusikuudetta	Optimisation hack for exceptional compound ’kuusikuudetta’
NUM_51kuusikvadriljardia	Optimisation hack for exceptional compound ’kuusikvadriljardia’
NUM_51kuusikvadriljoonaa	Optimisation hack for exceptional compound ’kuusikvadriljoonaa’
NUM_51kuusikvintiljardia	Optimisation hack for exceptional compound ’kuusikvintiljardia’
NUM_51kuusikvintiljoonaa	Optimisation hack for exceptional compound ’kuusikvintiljoonaa’
NUM_51kuusikymmentä	Optimisation hack for exceptional compound ’kuusikymmentä’
NUM_51kuusimiljardia	Optimisation hack for exceptional compound ’kuusimiljardia’
NUM_51kuusimiljoonaa	Optimisation hack for exceptional compound ’kuusimiljoonaa’
NUM_51kuusineljättä	Optimisation hack for exceptional compound ’kuusineljättä’
NUM_51kuusinoniljardia	Optimisation hack for exceptional compound ’kuusinoniljardia’
NUM_51kuusinoniljoonaa	Optimisation hack for exceptional compound ’kuusinoniljoonaa’
NUM_51kuusioktiljardia	Optimisation hack for exceptional compound ’kuusioktiljardia’
NUM_51kuusioktiljoonaa	Optimisation hack for exceptional compound ’kuusioktiljoonaa’
NUM_51kuusipiljardia	Optimisation hack for exceptional compound ’kuusipiljardia’
NUM_51kuusipiljoonaa	Optimisation hack for exceptional compound ’kuusipiljoonaa’
NUM_51kuusisataa	Optimisation hack for exceptional compound ’kuusisataa’
NUM_51kuusiseitsemättä	Optimisation hack for exceptional compound ’kuusiseitsemättä’
NUM_51kuusisentiljardia	Optimisation hack for exceptional compound ’kuusisentiljardia’
NUM_51kuusisentiljoonaa	Optimisation hack for exceptional compound ’kuusisentiljoonaa’
NUM_51kuusiseptiljardia	Optimisation hack for exceptional compound ’kuusiseptiljardia’
NUM_51kuusiseptiljoonaa	Optimisation hack for exceptional compound ’kuusiseptiljoonaa’
NUM_51kuusitoista	Optimisation hack for exceptional compound ’kuusitoista’
NUM_51kuusitredekiljardia	Optimisation hack for exceptional compound ’kuusitredekiljardia’
NUM_51kuusitredekiljoonaa	Optimisation hack for exceptional compound ’kuusitredekiljoonaa’
NUM_51kuusitriljardia	Optimisation hack for exceptional compound ’kuusitriljardia’
NUM_51kuusitriljoonaa	Optimisation hack for exceptional compound ’kuusitriljoonaa’
NUM_51kuusitsiljardia	Optimisation hack for exceptional compound ’kuusitsiljardia’
NUM_51kuusitsiljoonaa	Optimisation hack for exceptional compound ’kuusitsiljoonaa’
NUM_51kuusituhatta	Optimisation hack for exceptional compound ’kuusituhatta’
NUM_51kuusiundekiljardia	Optimisation hack for exceptional compound ’kuusiundekiljardia’
NUM_51kuusiundekiljoonaa	Optimisation hack for exceptional compound ’kuusiundekiljoonaa’
NUM_51kuusiviidettä	Optimisation hack for exceptional compound ’kuusiviidettä’
NUM_51kuusiyhdeksättä	Optimisation hack for exceptional compound ’kuusiyhdeksättä’
NUM_51neljäbiljardia	Optimisation hack for exceptional compound ’neljäbiljardia’
NUM_51neljäbiljoonaa	Optimisation hack for exceptional compound ’neljäbiljoonaa’
NUM_51neljädekiljardia	Optimisation hack for exceptional compound ’neljädekiljardia’
NUM_51neljädekiljoonaa	Optimisation hack for exceptional compound ’neljädekiljoonaa’
NUM_51neljäduodekiljardia	Optimisation hack for exceptional compound ’neljäduodekiljardia’
NUM_51neljäduodekiljoonaa	Optimisation hack for exceptional compound ’neljäduodekiljoonaa’
NUM_51neljäkahdeksatta	Optimisation hack for exceptional compound ’neljäkahdeksatta’
NUM_51neljäkiljardia	Optimisation hack for exceptional compound ’neljäkiljardia’
NUM_51neljäkiljoonaa	Optimisation hack for exceptional compound ’neljäkiljoonaa’
NUM_51neljäkolmatta	Optimisation hack for exceptional compound ’neljäkolmatta’
NUM_51neljäkuudetta	Optimisation hack for exceptional compound ’neljäkuudetta’
NUM_51neljäkvadriljardia	Optimisation hack for exceptional compound ’neljäkvadriljardia’
NUM_51neljäkvadriljoonaa	Optimisation hack for exceptional compound ’neljäkvadriljoonaa’
NUM_51neljäkvintiljardia	Optimisation hack for exceptional compound ’neljäkvintiljardia’
NUM_51neljäkvintiljoonaa	Optimisation hack for exceptional compound ’neljäkvintiljoonaa’
NUM_51neljäkymmentä	Optimisation hack for exceptional compound ’neljäkymmentä’
NUM_51neljämiljardia	Optimisation hack for exceptional compound ’neljämiljardia’
NUM_51neljämiljoonaa	Optimisation hack for exceptional compound ’neljämiljoonaa’
NUM_51neljäneljättä	Optimisation hack for exceptional compound ’neljäneljättä’
NUM_51neljänoniljardia	Optimisation hack for exceptional compound ’neljänoniljardia’
NUM_51neljänoniljoonaa	Optimisation hack for exceptional compound ’neljänoniljoonaa’
NUM_51neljäoktiljardia	Optimisation hack for exceptional compound ’neljäoktiljardia’
NUM_51neljäoktiljoonaa	Optimisation hack for exceptional compound ’neljäoktiljoonaa’
NUM_51neljäpiljardia	Optimisation hack for exceptional compound ’neljäpiljardia’
NUM_51neljäpiljoonaa	Optimisation hack for exceptional compound ’neljäpiljoonaa’
NUM_51neljäsataa	Optimisation hack for exceptional compound ’neljäsataa’
NUM_51neljäsbiljardis	Optimisation hack for exceptional compound ’neljäsbiljardis’
NUM_51neljäsbiljoonas	Optimisation hack for exceptional compound ’neljäsbiljoonas’
NUM_51neljäsdekiljardis	Optimisation hack for exceptional compound ’neljäsdekiljardis’
NUM_51neljäsdekiljoonas	Optimisation hack for exceptional compound ’neljäsdekiljoonas’
NUM_51neljäsduodekiljardis	Optimisation hack for exceptional compound ’neljäsduodekiljardis’
NUM_51neljäsduodekiljoonas	Optimisation hack for exceptional compound ’neljäsduodekiljoonas’
NUM_51neljäseitsemättä	Optimisation hack for exceptional compound ’neljäseitsemättä’
NUM_51neljäsentiljardia	Optimisation hack for exceptional compound ’neljäsentiljardia’
NUM_51neljäsentiljoonaa	Optimisation hack for exceptional compound ’neljäsentiljoonaa’
NUM_51neljäseptiljardia	Optimisation hack for exceptional compound ’neljäseptiljardia’
NUM_51neljäseptiljoonaa	Optimisation hack for exceptional compound ’neljäseptiljoonaa’
NUM_51neljäskahdeksatta	Optimisation hack for exceptional compound ’neljäskahdeksatta’
NUM_51neljäskiljardis	Optimisation hack for exceptional compound ’neljäskiljardis’
NUM_51neljäskiljoonas	Optimisation hack for exceptional compound ’neljäskiljoonas’
NUM_51neljäskolmatta	Optimisation hack for exceptional compound ’neljäskolmatta’
NUM_51neljäskuudetta	Optimisation hack for exceptional compound ’neljäskuudetta’
NUM_51neljäskvadriljardis	Optimisation hack for exceptional compound ’neljäskvadriljardis’
NUM_51neljäskvadriljoonas	Optimisation hack for exceptional compound ’neljäskvadriljoonas’
NUM_51neljäskvintiljardis	Optimisation hack for exceptional compound ’neljäskvintiljardis’
NUM_51neljäskvintiljoonas	Optimisation hack for exceptional compound ’neljäskvintiljoonas’
NUM_51neljäskymmenes	Optimisation hack for exceptional compound ’neljäskymmenes’
NUM_51neljäsmiljardis	Optimisation hack for exceptional compound ’neljäsmiljardis’
NUM_51neljäsmiljoonas	Optimisation hack for exceptional compound ’neljäsmiljoonas’
NUM_51neljäsneljättä	Optimisation hack for exceptional compound ’neljäsneljättä’
NUM_51neljäsnoniljardis	Optimisation hack for exceptional compound ’neljäsnoniljardis’
NUM_51neljäsnoniljoonas	Optimisation hack for exceptional compound ’neljäsnoniljoonas’
NUM_51neljäsoktiljardis	Optimisation hack for exceptional compound ’neljäsoktiljardis’
NUM_51neljäsoktiljoonas	Optimisation hack for exceptional compound ’neljäsoktiljoonas’
NUM_51neljäspiljardis	Optimisation hack for exceptional compound ’neljäspiljardis’
NUM_51neljäspiljoonas	Optimisation hack for exceptional compound ’neljäspiljoonas’
NUM_51neljässadas	Optimisation hack for exceptional compound ’neljässadas’
NUM_51neljässeitsemättä	Optimisation hack for exceptional compound ’neljässeitsemättä’
NUM_51neljässentiljardis	Optimisation hack for exceptional compound ’neljässentiljardis’
NUM_51neljässentiljoonas	Optimisation hack for exceptional compound ’neljässentiljoonas’
NUM_51neljässeptiljardis	Optimisation hack for exceptional compound ’neljässeptiljardis’
NUM_51neljässeptiljoonas	Optimisation hack for exceptional compound ’neljässeptiljoonas’
NUM_51neljästoista	Optimisation hack for exceptional compound ’neljästoista’
NUM_51neljästredekiljardis	Optimisation hack for exceptional compound ’neljästredekiljardis’
NUM_51neljästredekiljoonas	Optimisation hack for exceptional compound ’neljästredekiljoonas’
NUM_51neljästriljardis	Optimisation hack for exceptional compound ’neljästriljardis’
NUM_51neljästriljoonas	Optimisation hack for exceptional compound ’neljästriljoonas’
NUM_51neljästsiljardis	Optimisation hack for exceptional compound ’neljästsiljardis’
NUM_51neljästsiljoonas	Optimisation hack for exceptional compound ’neljästsiljoonas’
NUM_51neljästuhannes	Optimisation hack for exceptional compound ’neljästuhannes’
NUM_51neljäsundekiljardis	Optimisation hack for exceptional compound ’neljäsundekiljardis’
NUM_51neljäsundekiljoonas	Optimisation hack for exceptional compound ’neljäsundekiljoonas’
NUM_51neljäsviidettä	Optimisation hack for exceptional compound ’neljäsviidettä’
NUM_51neljäsyhdeksättä	Optimisation hack for exceptional compound ’neljäsyhdeksättä’
NUM_51neljätoista	Optimisation hack for exceptional compound ’neljätoista’
NUM_51neljätredekiljardia	Optimisation hack for exceptional compound ’neljätredekiljardia’
NUM_51neljätredekiljoonaa	Optimisation hack for exceptional compound ’neljätredekiljoonaa’
NUM_51neljätriljardia	Optimisation hack for exceptional compound ’neljätriljardia’
NUM_51neljätriljoonaa	Optimisation hack for exceptional compound ’neljätriljoonaa’
NUM_51neljätsiljardia	Optimisation hack for exceptional compound ’neljätsiljardia’
NUM_51neljätsiljoonaa	Optimisation hack for exceptional compound ’neljätsiljoonaa’
NUM_51neljätuhatta	Optimisation hack for exceptional compound ’neljätuhatta’
NUM_51neljäundekiljardia	Optimisation hack for exceptional compound ’neljäundekiljardia’
NUM_51neljäundekiljoonaa	Optimisation hack for exceptional compound ’neljäundekiljoonaa’
NUM_51neljäviidettä	Optimisation hack for exceptional compound ’neljäviidettä’
NUM_51neljäyhdeksättä	Optimisation hack for exceptional compound ’neljäyhdeksättä’
NUM_51puolitoista	Optimisation hack for exceptional compound ’puolitoista’
NUM_51seitsemänbiljardia	Optimisation hack for exceptional compound ’seitsemänbiljardia’
NUM_51seitsemänbiljoonaa	Optimisation hack for exceptional compound ’seitsemänbiljoonaa’
NUM_51seitsemändekiljardia	Optimisation hack for exceptional compound ’seitsemändekiljardia’
NUM_51seitsemändekiljoonaa	Optimisation hack for exceptional compound ’seitsemändekiljoonaa’
NUM_51seitsemänduodekiljardia	Optimisation hack for exceptional compound ’seitsemänduodekiljardia’
NUM_51seitsemänduodekiljoonaa	Optimisation hack for exceptional compound ’seitsemänduodekiljoonaa’
NUM_51seitsemänkahdeksatta	Optimisation hack for exceptional compound ’seitsemänkahdeksatta’
NUM_51seitsemänkiljardia	Optimisation hack for exceptional compound ’seitsemänkiljardia’
NUM_51seitsemänkiljoonaa	Optimisation hack for exceptional compound ’seitsemänkiljoonaa’
NUM_51seitsemänkolmatta	Optimisation hack for exceptional compound ’seitsemänkolmatta’
NUM_51seitsemänkuudetta	Optimisation hack for exceptional compound ’seitsemänkuudetta’
NUM_51seitsemänkvadriljardia	Optimisation hack for exceptional compound ’seitsemänkvadriljardia’
NUM_51seitsemänkvadriljoonaa	Optimisation hack for exceptional compound ’seitsemänkvadriljoonaa’
NUM_51seitsemänkvintiljardia	Optimisation hack for exceptional compound ’seitsemänkvintiljardia’
NUM_51seitsemänkvintiljoonaa	Optimisation hack for exceptional compound ’seitsemänkvintiljoonaa’
NUM_51seitsemänkymmentä	Optimisation hack for exceptional compound ’seitsemänkymmentä’
NUM_51seitsemänmiljardia	Optimisation hack for exceptional compound ’seitsemänmiljardia’
NUM_51seitsemänmiljoonaa	Optimisation hack for exceptional compound ’seitsemänmiljoonaa’
NUM_51seitsemänneljättä	Optimisation hack for exceptional compound ’seitsemänneljättä’
NUM_51seitsemännoniljardia	Optimisation hack for exceptional compound ’seitsemännoniljardia’
NUM_51seitsemännoniljoonaa	Optimisation hack for exceptional compound ’seitsemännoniljoonaa’
NUM_51seitsemänoktiljardia	Optimisation hack for exceptional compound ’seitsemänoktiljardia’
NUM_51seitsemänoktiljoonaa	Optimisation hack for exceptional compound ’seitsemänoktiljoonaa’
NUM_51seitsemänpiljardia	Optimisation hack for exceptional compound ’seitsemänpiljardia’
NUM_51seitsemänpiljoonaa	Optimisation hack for exceptional compound ’seitsemänpiljoonaa’
NUM_51seitsemänsataa	Optimisation hack for exceptional compound ’seitsemänsataa’
NUM_51seitsemänseitsemättä	Optimisation hack for exceptional compound ’seitsemänseitsemättä’
NUM_51seitsemänsentiljardia	Optimisation hack for exceptional compound ’seitsemänsentiljardia’
NUM_51seitsemänsentiljoonaa	Optimisation hack for exceptional compound ’seitsemänsentiljoonaa’
NUM_51seitsemänseptiljardia	Optimisation hack for exceptional compound ’seitsemänseptiljardia’
NUM_51seitsemänseptiljoonaa	Optimisation hack for exceptional compound ’seitsemänseptiljoonaa’
NUM_51seitsemäntoista	Optimisation hack for exceptional compound ’seitsemäntoista’
NUM_51seitsemäntredekiljardia	Optimisation hack for exceptional compound ’seitsemäntredekiljardia’
NUM_51seitsemäntredekiljoonaa	Optimisation hack for exceptional compound ’seitsemäntredekiljoonaa’
NUM_51seitsemäntriljardia	Optimisation hack for exceptional compound ’seitsemäntriljardia’
NUM_51seitsemäntriljoonaa	Optimisation hack for exceptional compound ’seitsemäntriljoonaa’
NUM_51seitsemäntsiljardia	Optimisation hack for exceptional compound ’seitsemäntsiljardia’
NUM_51seitsemäntsiljoonaa	Optimisation hack for exceptional compound ’seitsemäntsiljoonaa’
NUM_51seitsemäntuhatta	Optimisation hack for exceptional compound ’seitsemäntuhatta’
NUM_51seitsemänundekiljardia	Optimisation hack for exceptional compound ’seitsemänundekiljardia’
NUM_51seitsemänundekiljoonaa	Optimisation hack for exceptional compound ’seitsemänundekiljoonaa’
NUM_51seitsemänviidettä	Optimisation hack for exceptional compound ’seitsemänviidettä’
NUM_51seitsemänyhdeksättä	Optimisation hack for exceptional compound ’seitsemänyhdeksättä’
NUM_51seitsemäsbiljardis	Optimisation hack for exceptional compound ’seitsemäsbiljardis’
NUM_51seitsemäsbiljoonas	Optimisation hack for exceptional compound ’seitsemäsbiljoonas’
NUM_51seitsemäsdekiljardis	Optimisation hack for exceptional compound ’seitsemäsdekiljardis’
NUM_51seitsemäsdekiljoonas	Optimisation hack for exceptional compound ’seitsemäsdekiljoonas’
NUM_51seitsemäsduodekiljardis	Optimisation hack for exceptional compound ’seitsemäsduodekiljardis’
NUM_51seitsemäsduodekiljoonas	Optimisation hack for exceptional compound ’seitsemäsduodekiljoonas’
NUM_51seitsemäskahdeksatta	Optimisation hack for exceptional compound ’seitsemäskahdeksatta’
NUM_51seitsemäskiljardis	Optimisation hack for exceptional compound ’seitsemäskiljardis’
NUM_51seitsemäskiljoonas	Optimisation hack for exceptional compound ’seitsemäskiljoonas’
NUM_51seitsemäskolmatta	Optimisation hack for exceptional compound ’seitsemäskolmatta’
NUM_51seitsemäskuudetta	Optimisation hack for exceptional compound ’seitsemäskuudetta’
NUM_51seitsemäskvadriljardis	Optimisation hack for exceptional compound ’seitsemäskvadriljardis’
NUM_51seitsemäskvadriljoonas	Optimisation hack for exceptional compound ’seitsemäskvadriljoonas’
NUM_51seitsemäskvintiljardis	Optimisation hack for exceptional compound ’seitsemäskvintiljardis’
NUM_51seitsemäskvintiljoonas	Optimisation hack for exceptional compound ’seitsemäskvintiljoonas’
NUM_51seitsemäskymmenes	Optimisation hack for exceptional compound ’seitsemäskymmenes’
NUM_51seitsemäsmiljardis	Optimisation hack for exceptional compound ’seitsemäsmiljardis’
NUM_51seitsemäsmiljoonas	Optimisation hack for exceptional compound ’seitsemäsmiljoonas’
NUM_51seitsemäsneljättä	Optimisation hack for exceptional compound ’seitsemäsneljättä’
NUM_51seitsemäsnoniljardis	Optimisation hack for exceptional compound ’seitsemäsnoniljardis’
NUM_51seitsemäsnoniljoonas	Optimisation hack for exceptional compound ’seitsemäsnoniljoonas’
NUM_51seitsemäsoktiljardis	Optimisation hack for exceptional compound ’seitsemäsoktiljardis’
NUM_51seitsemäsoktiljoonas	Optimisation hack for exceptional compound ’seitsemäsoktiljoonas’
NUM_51seitsemäspiljardis	Optimisation hack for exceptional compound ’seitsemäspiljardis’
NUM_51seitsemäspiljoonas	Optimisation hack for exceptional compound ’seitsemäspiljoonas’
NUM_51seitsemässadas	Optimisation hack for exceptional compound ’seitsemässadas’
NUM_51seitsemässeitsemättä	Optimisation hack for exceptional compound ’seitsemässeitsemättä’
NUM_51seitsemässentiljardis	Optimisation hack for exceptional compound ’seitsemässentiljardis’
NUM_51seitsemässentiljoonas	Optimisation hack for exceptional compound ’seitsemässentiljoonas’
NUM_51seitsemässeptiljardis	Optimisation hack for exceptional compound ’seitsemässeptiljardis’
NUM_51seitsemässeptiljoonas	Optimisation hack for exceptional compound ’seitsemässeptiljoonas’
NUM_51seitsemästoista	Optimisation hack for exceptional compound ’seitsemästoista’
NUM_51seitsemästredekiljardis	Optimisation hack for exceptional compound ’seitsemästredekiljardis’
NUM_51seitsemästredekiljoonas	Optimisation hack for exceptional compound ’seitsemästredekiljoonas’
NUM_51seitsemästriljardis	Optimisation hack for exceptional compound ’seitsemästriljardis’
NUM_51seitsemästriljoonas	Optimisation hack for exceptional compound ’seitsemästriljoonas’
NUM_51seitsemästsiljardis	Optimisation hack for exceptional compound ’seitsemästsiljardis’
NUM_51seitsemästsiljoonas	Optimisation hack for exceptional compound ’seitsemästsiljoonas’
NUM_51seitsemästuhannes	Optimisation hack for exceptional compound ’seitsemästuhannes’
NUM_51seitsemäsundekiljardis	Optimisation hack for exceptional compound ’seitsemäsundekiljardis’
NUM_51seitsemäsundekiljoonas	Optimisation hack for exceptional compound ’seitsemäsundekiljoonas’
NUM_51seitsemäsviidettä	Optimisation hack for exceptional compound ’seitsemäsviidettä’
NUM_51seitsemäsyhdeksättä	Optimisation hack for exceptional compound ’seitsemäsyhdeksättä’
NUM_51viidesbiljardis	Optimisation hack for exceptional compound ’viidesbiljardis’
NUM_51viidesbiljoonas	Optimisation hack for exceptional compound ’viidesbiljoonas’
NUM_51viidesdekiljardis	Optimisation hack for exceptional compound ’viidesdekiljardis’
NUM_51viidesdekiljoonas	Optimisation hack for exceptional compound ’viidesdekiljoonas’
NUM_51viidesduodekiljardis	Optimisation hack for exceptional compound ’viidesduodekiljardis’
NUM_51viidesduodekiljoonas	Optimisation hack for exceptional compound ’viidesduodekiljoonas’
NUM_51viideskahdeksatta	Optimisation hack for exceptional compound ’viideskahdeksatta’
NUM_51viideskiljardis	Optimisation hack for exceptional compound ’viideskiljardis’
NUM_51viideskiljoonas	Optimisation hack for exceptional compound ’viideskiljoonas’
NUM_51viideskolmatta	Optimisation hack for exceptional compound ’viideskolmatta’
NUM_51viideskuudetta	Optimisation hack for exceptional compound ’viideskuudetta’
NUM_51viideskvadriljardis	Optimisation hack for exceptional compound ’viideskvadriljardis’
NUM_51viideskvadriljoonas	Optimisation hack for exceptional compound ’viideskvadriljoonas’
NUM_51viideskvintiljardis	Optimisation hack for exceptional compound ’viideskvintiljardis’
NUM_51viideskvintiljoonas	Optimisation hack for exceptional compound ’viideskvintiljoonas’
NUM_51viideskymmenes	Optimisation hack for exceptional compound ’viideskymmenes’
NUM_51viidesmiljardis	Optimisation hack for exceptional compound ’viidesmiljardis’
NUM_51viidesmiljoonas	Optimisation hack for exceptional compound ’viidesmiljoonas’
NUM_51viidesneljättä	Optimisation hack for exceptional compound ’viidesneljättä’
NUM_51viidesnoniljardis	Optimisation hack for exceptional compound ’viidesnoniljardis’
NUM_51viidesnoniljoonas	Optimisation hack for exceptional compound ’viidesnoniljoonas’
NUM_51viidesoktiljardis	Optimisation hack for exceptional compound ’viidesoktiljardis’
NUM_51viidesoktiljoonas	Optimisation hack for exceptional compound ’viidesoktiljoonas’
NUM_51viidespiljardis	Optimisation hack for exceptional compound ’viidespiljardis’
NUM_51viidespiljoonas	Optimisation hack for exceptional compound ’viidespiljoonas’
NUM_51viidessadas	Optimisation hack for exceptional compound ’viidessadas’
NUM_51viidesseitsemättä	Optimisation hack for exceptional compound ’viidesseitsemättä’
NUM_51viidessentiljardis	Optimisation hack for exceptional compound ’viidessentiljardis’
NUM_51viidessentiljoonas	Optimisation hack for exceptional compound ’viidessentiljoonas’
NUM_51viidesseptiljardis	Optimisation hack for exceptional compound ’viidesseptiljardis’
NUM_51viidesseptiljoonas	Optimisation hack for exceptional compound ’viidesseptiljoonas’
NUM_51viidestoista	Optimisation hack for exceptional compound ’viidestoista’
NUM_51viidestredekiljardis	Optimisation hack for exceptional compound ’viidestredekiljardis’
NUM_51viidestredekiljoonas	Optimisation hack for exceptional compound ’viidestredekiljoonas’
NUM_51viidestriljardis	Optimisation hack for exceptional compound ’viidestriljardis’
NUM_51viidestriljoonas	Optimisation hack for exceptional compound ’viidestriljoonas’
NUM_51viidestsiljardis	Optimisation hack for exceptional compound ’viidestsiljardis’
NUM_51viidestsiljoonas	Optimisation hack for exceptional compound ’viidestsiljoonas’
NUM_51viidestuhannes	Optimisation hack for exceptional compound ’viidestuhannes’
NUM_51viidesundekiljardis	Optimisation hack for exceptional compound ’viidesundekiljardis’
NUM_51viidesundekiljoonas	Optimisation hack for exceptional compound ’viidesundekiljoonas’
NUM_51viidesviidettä	Optimisation hack for exceptional compound ’viidesviidettä’
NUM_51viidesyhdeksättä	Optimisation hack for exceptional compound ’viidesyhdeksättä’
NUM_51viisibiljardia	Optimisation hack for exceptional compound ’viisibiljardia’
NUM_51viisibiljoonaa	Optimisation hack for exceptional compound ’viisibiljoonaa’
NUM_51viisidekiljardia	Optimisation hack for exceptional compound ’viisidekiljardia’
NUM_51viisidekiljoonaa	Optimisation hack for exceptional compound ’viisidekiljoonaa’
NUM_51viisiduodekiljardia	Optimisation hack for exceptional compound ’viisiduodekiljardia’
NUM_51viisiduodekiljoonaa	Optimisation hack for exceptional compound ’viisiduodekiljoonaa’
NUM_51viisikahdeksatta	Optimisation hack for exceptional compound ’viisikahdeksatta’
NUM_51viisikiljardia	Optimisation hack for exceptional compound ’viisikiljardia’
NUM_51viisikiljoonaa	Optimisation hack for exceptional compound ’viisikiljoonaa’
NUM_51viisikolmatta	Optimisation hack for exceptional compound ’viisikolmatta’
NUM_51viisikuudetta	Optimisation hack for exceptional compound ’viisikuudetta’
NUM_51viisikvadriljardia	Optimisation hack for exceptional compound ’viisikvadriljardia’
NUM_51viisikvadriljoonaa	Optimisation hack for exceptional compound ’viisikvadriljoonaa’
NUM_51viisikvintiljardia	Optimisation hack for exceptional compound ’viisikvintiljardia’
NUM_51viisikvintiljoonaa	Optimisation hack for exceptional compound ’viisikvintiljoonaa’
NUM_51viisikymmentä	Optimisation hack for exceptional compound ’viisikymmentä’
NUM_51viisimiljardia	Optimisation hack for exceptional compound ’viisimiljardia’
NUM_51viisimiljoonaa	Optimisation hack for exceptional compound ’viisimiljoonaa’
NUM_51viisineljättä	Optimisation hack for exceptional compound ’viisineljättä’
NUM_51viisinoniljardia	Optimisation hack for exceptional compound ’viisinoniljardia’
NUM_51viisinoniljoonaa	Optimisation hack for exceptional compound ’viisinoniljoonaa’
NUM_51viisioktiljardia	Optimisation hack for exceptional compound ’viisioktiljardia’
NUM_51viisioktiljoonaa	Optimisation hack for exceptional compound ’viisioktiljoonaa’
NUM_51viisipiljardia	Optimisation hack for exceptional compound ’viisipiljardia’
NUM_51viisipiljoonaa	Optimisation hack for exceptional compound ’viisipiljoonaa’
NUM_51viisisataa	Optimisation hack for exceptional compound ’viisisataa’
NUM_51viisiseitsemättä	Optimisation hack for exceptional compound ’viisiseitsemättä’
NUM_51viisisentiljardia	Optimisation hack for exceptional compound ’viisisentiljardia’
NUM_51viisisentiljoonaa	Optimisation hack for exceptional compound ’viisisentiljoonaa’
NUM_51viisiseptiljardia	Optimisation hack for exceptional compound ’viisiseptiljardia’
NUM_51viisiseptiljoonaa	Optimisation hack for exceptional compound ’viisiseptiljoonaa’
NUM_51viisitoista	Optimisation hack for exceptional compound ’viisitoista’
NUM_51viisitredekiljardia	Optimisation hack for exceptional compound ’viisitredekiljardia’
NUM_51viisitredekiljoonaa	Optimisation hack for exceptional compound ’viisitredekiljoonaa’
NUM_51viisitriljardia	Optimisation hack for exceptional compound ’viisitriljardia’
NUM_51viisitriljoonaa	Optimisation hack for exceptional compound ’viisitriljoonaa’
NUM_51viisitsiljardia	Optimisation hack for exceptional compound ’viisitsiljardia’
NUM_51viisitsiljoonaa	Optimisation hack for exceptional compound ’viisitsiljoonaa’
NUM_51viisituhatta	Optimisation hack for exceptional compound ’viisituhatta’
NUM_51viisiundekiljardia	Optimisation hack for exceptional compound ’viisiundekiljardia’
NUM_51viisiundekiljoonaa	Optimisation hack for exceptional compound ’viisiundekiljoonaa’
NUM_51viisiviidettä	Optimisation hack for exceptional compound ’viisiviidettä’
NUM_51viisiyhdeksättä	Optimisation hack for exceptional compound ’viisiyhdeksättä’
NUM_51yhdeksänbiljardia	Optimisation hack for exceptional compound ’yhdeksänbiljardia’
NUM_51yhdeksänbiljoonaa	Optimisation hack for exceptional compound ’yhdeksänbiljoonaa’
NUM_51yhdeksändekiljardia	Optimisation hack for exceptional compound ’yhdeksändekiljardia’
NUM_51yhdeksändekiljoonaa	Optimisation hack for exceptional compound ’yhdeksändekiljoonaa’
NUM_51yhdeksänduodekiljardia	Optimisation hack for exceptional compound ’yhdeksänduodekiljardia’
NUM_51yhdeksänduodekiljoonaa	Optimisation hack for exceptional compound ’yhdeksänduodekiljoonaa’
NUM_51yhdeksänkahdeksatta	Optimisation hack for exceptional compound ’yhdeksänkahdeksatta’
NUM_51yhdeksänkiljardia	Optimisation hack for exceptional compound ’yhdeksänkiljardia’
NUM_51yhdeksänkiljoonaa	Optimisation hack for exceptional compound ’yhdeksänkiljoonaa’
NUM_51yhdeksänkolmatta	Optimisation hack for exceptional compound ’yhdeksänkolmatta’
NUM_51yhdeksänkuudetta	Optimisation hack for exceptional compound ’yhdeksänkuudetta’
NUM_51yhdeksänkvadriljardia	Optimisation hack for exceptional compound ’yhdeksänkvadriljardia’
NUM_51yhdeksänkvadriljoonaa	Optimisation hack for exceptional compound ’yhdeksänkvadriljoonaa’
NUM_51yhdeksänkvintiljardia	Optimisation hack for exceptional compound ’yhdeksänkvintiljardia’
NUM_51yhdeksänkvintiljoonaa	Optimisation hack for exceptional compound ’yhdeksänkvintiljoonaa’
NUM_51yhdeksänkymmentä	Optimisation hack for exceptional compound ’yhdeksänkymmentä’
NUM_51yhdeksänmiljardia	Optimisation hack for exceptional compound ’yhdeksänmiljardia’
NUM_51yhdeksänmiljoonaa	Optimisation hack for exceptional compound ’yhdeksänmiljoonaa’
NUM_51yhdeksänneljättä	Optimisation hack for exceptional compound ’yhdeksänneljättä’
NUM_51yhdeksännoniljardia	Optimisation hack for exceptional compound ’yhdeksännoniljardia’
NUM_51yhdeksännoniljoonaa	Optimisation hack for exceptional compound ’yhdeksännoniljoonaa’
NUM_51yhdeksänoktiljardia	Optimisation hack for exceptional compound ’yhdeksänoktiljardia’
NUM_51yhdeksänoktiljoonaa	Optimisation hack for exceptional compound ’yhdeksänoktiljoonaa’
NUM_51yhdeksänpiljardia	Optimisation hack for exceptional compound ’yhdeksänpiljardia’
NUM_51yhdeksänpiljoonaa	Optimisation hack for exceptional compound ’yhdeksänpiljoonaa’
NUM_51yhdeksänsataa	Optimisation hack for exceptional compound ’yhdeksänsataa’
NUM_51yhdeksänseitsemättä	Optimisation hack for exceptional compound ’yhdeksänseitsemättä’
NUM_51yhdeksänsentiljardia	Optimisation hack for exceptional compound ’yhdeksänsentiljardia’
NUM_51yhdeksänsentiljoonaa	Optimisation hack for exceptional compound ’yhdeksänsentiljoonaa’
NUM_51yhdeksänseptiljardia	Optimisation hack for exceptional compound ’yhdeksänseptiljardia’
NUM_51yhdeksänseptiljoonaa	Optimisation hack for exceptional compound ’yhdeksänseptiljoonaa’
NUM_51yhdeksäntoista	Optimisation hack for exceptional compound ’yhdeksäntoista’
NUM_51yhdeksäntredekiljardia	Optimisation hack for exceptional compound ’yhdeksäntredekiljardia’
NUM_51yhdeksäntredekiljoonaa	Optimisation hack for exceptional compound ’yhdeksäntredekiljoonaa’
NUM_51yhdeksäntriljardia	Optimisation hack for exceptional compound ’yhdeksäntriljardia’
NUM_51yhdeksäntriljoonaa	Optimisation hack for exceptional compound ’yhdeksäntriljoonaa’
NUM_51yhdeksäntsiljardia	Optimisation hack for exceptional compound ’yhdeksäntsiljardia’
NUM_51yhdeksäntsiljoonaa	Optimisation hack for exceptional compound ’yhdeksäntsiljoonaa’
NUM_51yhdeksäntuhatta	Optimisation hack for exceptional compound ’yhdeksäntuhatta’
NUM_51yhdeksänundekiljardia	Optimisation hack for exceptional compound ’yhdeksänundekiljardia’
NUM_51yhdeksänundekiljoonaa	Optimisation hack for exceptional compound ’yhdeksänundekiljoonaa’
NUM_51yhdeksänviidettä	Optimisation hack for exceptional compound ’yhdeksänviidettä’
NUM_51yhdeksänyhdeksättä	Optimisation hack for exceptional compound ’yhdeksänyhdeksättä’
NUM_51yhdeksäsbiljardis	Optimisation hack for exceptional compound ’yhdeksäsbiljardis’
NUM_51yhdeksäsbiljoonas	Optimisation hack for exceptional compound ’yhdeksäsbiljoonas’
NUM_51yhdeksäsdekiljardis	Optimisation hack for exceptional compound ’yhdeksäsdekiljardis’
NUM_51yhdeksäsdekiljoonas	Optimisation hack for exceptional compound ’yhdeksäsdekiljoonas’
NUM_51yhdeksäsduodekiljardis	Optimisation hack for exceptional compound ’yhdeksäsduodekiljardis’
NUM_51yhdeksäsduodekiljoonas	Optimisation hack for exceptional compound ’yhdeksäsduodekiljoonas’
NUM_51yhdeksäskahdeksatta	Optimisation hack for exceptional compound ’yhdeksäskahdeksatta’
NUM_51yhdeksäskiljardis	Optimisation hack for exceptional compound ’yhdeksäskiljardis’
NUM_51yhdeksäskiljoonas	Optimisation hack for exceptional compound ’yhdeksäskiljoonas’
NUM_51yhdeksäskolmatta	Optimisation hack for exceptional compound ’yhdeksäskolmatta’
NUM_51yhdeksäskuudetta	Optimisation hack for exceptional compound ’yhdeksäskuudetta’
NUM_51yhdeksäskvadriljardis	Optimisation hack for exceptional compound ’yhdeksäskvadriljardis’
NUM_51yhdeksäskvadriljoonas	Optimisation hack for exceptional compound ’yhdeksäskvadriljoonas’
NUM_51yhdeksäskvintiljardis	Optimisation hack for exceptional compound ’yhdeksäskvintiljardis’
NUM_51yhdeksäskvintiljoonas	Optimisation hack for exceptional compound ’yhdeksäskvintiljoonas’
NUM_51yhdeksäskymmenes	Optimisation hack for exceptional compound ’yhdeksäskymmenes’
NUM_51yhdeksäsmiljardis	Optimisation hack for exceptional compound ’yhdeksäsmiljardis’
NUM_51yhdeksäsmiljoonas	Optimisation hack for exceptional compound ’yhdeksäsmiljoonas’
NUM_51yhdeksäsneljättä	Optimisation hack for exceptional compound ’yhdeksäsneljättä’
NUM_51yhdeksäsnoniljardis	Optimisation hack for exceptional compound ’yhdeksäsnoniljardis’
NUM_51yhdeksäsnoniljoonas	Optimisation hack for exceptional compound ’yhdeksäsnoniljoonas’
NUM_51yhdeksäsoktiljardis	Optimisation hack for exceptional compound ’yhdeksäsoktiljardis’
NUM_51yhdeksäsoktiljoonas	Optimisation hack for exceptional compound ’yhdeksäsoktiljoonas’
NUM_51yhdeksäspiljardis	Optimisation hack for exceptional compound ’yhdeksäspiljardis’
NUM_51yhdeksäspiljoonas	Optimisation hack for exceptional compound ’yhdeksäspiljoonas’
NUM_51yhdeksässadas	Optimisation hack for exceptional compound ’yhdeksässadas’
NUM_51yhdeksässeitsemättä	Optimisation hack for exceptional compound ’yhdeksässeitsemättä’
NUM_51yhdeksässentiljardis	Optimisation hack for exceptional compound ’yhdeksässentiljardis’
NUM_51yhdeksässentiljoonas	Optimisation hack for exceptional compound ’yhdeksässentiljoonas’
NUM_51yhdeksässeptiljardis	Optimisation hack for exceptional compound ’yhdeksässeptiljardis’
NUM_51yhdeksässeptiljoonas	Optimisation hack for exceptional compound ’yhdeksässeptiljoonas’
NUM_51yhdeksästoista	Optimisation hack for exceptional compound ’yhdeksästoista’
NUM_51yhdeksästredekiljardis	Optimisation hack for exceptional compound ’yhdeksästredekiljardis’
NUM_51yhdeksästredekiljoonas	Optimisation hack for exceptional compound ’yhdeksästredekiljoonas’
NUM_51yhdeksästriljardis	Optimisation hack for exceptional compound ’yhdeksästriljardis’
NUM_51yhdeksästriljoonas	Optimisation hack for exceptional compound ’yhdeksästriljoonas’
NUM_51yhdeksästsiljardis	Optimisation hack for exceptional compound ’yhdeksästsiljardis’
NUM_51yhdeksästsiljoonas	Optimisation hack for exceptional compound ’yhdeksästsiljoonas’
NUM_51yhdeksästuhannes	Optimisation hack for exceptional compound ’yhdeksästuhannes’
NUM_51yhdeksäsundekiljardis	Optimisation hack for exceptional compound ’yhdeksäsundekiljardis’
NUM_51yhdeksäsundekiljoonas	Optimisation hack for exceptional compound ’yhdeksäsundekiljoonas’
NUM_51yhdeksäsviidettä	Optimisation hack for exceptional compound ’yhdeksäsviidettä’
NUM_51yhdeksäsyhdeksättä	Optimisation hack for exceptional compound ’yhdeksäsyhdeksättä’
NUM_51yhdeskahdeksatta	Optimisation hack for exceptional compound ’yhdeskahdeksatta’
NUM_51yhdeskolmatta	Optimisation hack for exceptional compound ’yhdeskolmatta’
NUM_51yhdeskuudetta	Optimisation hack for exceptional compound ’yhdeskuudetta’
NUM_51yhdesneljättä	Optimisation hack for exceptional compound ’yhdesneljättä’
NUM_51yhdesseitsemättä	Optimisation hack for exceptional compound ’yhdesseitsemättä’
NUM_51yhdestoista	Optimisation hack for exceptional compound ’yhdestoista’
NUM_51yhdesviidettä	Optimisation hack for exceptional compound ’yhdesviidettä’
NUM_51yhdesyhdeksättä	Optimisation hack for exceptional compound ’yhdesyhdeksättä’
NUM_51yksikahdeksatta	Optimisation hack for exceptional compound ’yksikahdeksatta’
NUM_51yksikolmatta	Optimisation hack for exceptional compound ’yksikolmatta’
NUM_51yksikuudetta	Optimisation hack for exceptional compound ’yksikuudetta’
NUM_51yksineljättä	Optimisation hack for exceptional compound ’yksineljättä’
NUM_51yksiseitsemättä	Optimisation hack for exceptional compound ’yksiseitsemättä’
NUM_51yksitoista	Optimisation hack for exceptional compound ’yksitoista’
NUM_51yksiviidettä	Optimisation hack for exceptional compound ’yksiviidettä’
NUM_51yksiyhdeksättä	Optimisation hack for exceptional compound ’yksiyhdeksättä’
NUM_ENSIMMÄINEN	Ordinal nen stem front harmony (OBSOLETE)
NUM_KAHDEKSAN	an stem, an : ann : ans variations
NUM_KAKSI	ksi stem, ksi : ht variations back harmony
NUM_KOLMAS	Ordinal as stem, as : ann : ans variations (OBSOLETE)
NUM_KOLMASOSA	Numerals for parts ‛-osa’ inflect like NOUN_ASEMA
NUM_KOLME	e stem, e : 0 variations
NUM_KUUSI	si stem, si : te variations back harmony
NUM_KUUTISEN	Approximative numerals, back suffixes, compounding, select multipliers
NUM_KYMMEN	en stem no variations
NUM_KYMMENEN	en stem en : 0 variations
NUM_KYMMENKUNTA	Approximative numerals, no inflection
NUM_KYMMENTÄ	bound numeral multiplier
NUM_MILJARDI	i stem i : e variations back harmony
NUM_MILJOONA	a stem a : 0 variatons
NUM_NELJÄ	ä stem, ä : 0 variations
NUM_NELJÄS	äs stem 
NUM_PARI	i stem i : e variations back haqrmony
NUM_PUOLI	i stem i : e variations back harmoby
NUM_SATA	ta stem ta : do variations
NUM_TOINEN	Ordinal nen stem, nen : se variations back harmony (OLD)
NUM_TUHAT	t stem, t : ns variations back harmony
NUM_VIISI	si stem, si : de variations front harmony
NUM_VIITISEN	approximative numerals, front suffixes, compounding, select multipliers
NUM_YHDEKSÄN	än stem, än : änn : äns variations
NUM_YKSI	ksi stem, ksi : ht variations front harmony
PRON_ERÄS	s stem, s : ä variations
PRON_HÄN	personal pronoun ‘hän’ inflects, e stem, singular only
PRON_HÄÄ	dialectal forms of ‘hän’
PRON_ITSE	‘itse’, no variatinos
PRON_JOKA	‘joka’ inflects from jo stem, optionally ka clitic for most forms
PRON_JOKAINEN	nen stem nen : se variations back harmony
PRON_JOKIN	‘jokin’ inflect before kin clitic
PRON_JOKU	‘joku’ inflects, agreement like compound 51 jo+ku
PRON_JOMPIKUMPI	‘jompikumpi’ inflects, agreement like compound 51 jompi+kumpi c.f. PRON_KUMPI
PRON_KAIKKI	‘kaikki’, kki : ke variations
PRON_KOKO	no inflections or even clitics
PRON_KUKA	‘kuka’ has heteroclitic ke stem for inflection as well as more rare or diaectal ku- etc.
PRON_KUKAAN	‘kukaan’ inflects like PRON_KUKA before kaan clitic
PRON_KUKAKIN	‘kukakin’ inflects like PRON_KUKA before kin clitic
PRON_KUKIN	‘kukin’ inflects before kin clitic, only ku stem
PRON_KUMPI	‘kumpi’, mpi : mma variaitons
PRON_KUMPIKAAN	‘kumpikaan’ inflects like PRON_KUMPI before kaan clitic
PRON_KUMPIKIN	‘kumpikaan’ inflects like PRON_KUMPI before kin clitic
PRON_MA	dialectal forms of minä
PRON_ME	‘me, te, he’ inflect, e stems, plural only
PRON_MIE	dialectal forms of minä, inflects, u stem
PRON_MIKIN	mikin inflects before kin clitic
PRON_MIKÄ	mikä inflects from mi- stem, before kä clitic
PRON_MIKÄKIN	mikäkin does not inflects
PRON_MIKÄÄN	mikään inflects, mi- stem, clitic kään
PRON_MINÄ	‘minä, sinä’ inflect, u stem, singular only
PRON_MOLEMMAT	pronouns that do not inflect
PRON_MONES	s stem, s : nne variaitns
PRON_MONI	i stem, i : e variations
PRON_MONIAS	as stem, as : aa variations
PRON_MONTA	‘monta’ inflects ‘montaa’ (i.e. to avoid double partitive)
PRON_MONTAKO	partitive, clitic lexicalised, no inflections
PRON_MUU	uu stem, uu : u variaotns
PRON_MUUAN	no inflects
PRON_MUUTAMA	a stems, a : 0 variations
PRON_MÄ	dialectal forms of minä
PRON_MÄÄ	dialectal forms of minä
PRON_NE	e stem, e : i, plurals only
PRON_NOI	dialectal forms of ‘nuo’
PRON_NUO	uo stem, uo : o variationt, plurals only
PRON_NÄMÄ	ä stem, mä : 0 variations, plurals only
PRON_SAMA	a stem, a : o variations
PRON_SE	e stem, e : ii variations singulars only
PRON_TOI	dialectal forms of ‘nuo’
PRON_TOINEN	nen stem nen : se variations back harmoy
PRON_TUO	uo stem, uo : o variations singulars only
PRON_TÄMÄ	ä stem mä : 0 variations, singulars only
PRON_USEA	ea stem, a : 0 variations
PRON_USEAMPI	mpi stem mpi : mm variations
PRON_USEIMMAT	mmat stem  mmat : mm variations plurals only
PRON_YKSI	ksi stem, ksi : ht variatons
PROPN_51Iso-Britannia	Optimisation hack for exceptional compound ’Iso-Britannia’
PROPN_51Mustameri	Optimisation hack for exceptional compound ’Mustameri’
PROPN_51Punainenmeri	Optimisation hack for exceptional compound ’Punainenmeri’
PROPN_51Tyynimeri	Optimisation hack for exceptional compound ’Tyynimeri’
PROPN_51Uusi-Englanti	Optimisation hack for exceptional compound ’Uusi-Guinea’
PROPN_51Uusi-Guinea	Optimisation hack for exceptional compound ’Uusi-Englanti’
PROPN_51Uusi-Seelanti	Optimisation hack for exceptional compound ’Uusi-Seelanti’
PROPN_51Uusikaupunki	Optimisation hack for exceptional compound ’Uusikaupunki’
PROPN_51Uusimaa	Optimisation hack for exceptional compound ’Uusimaa’
PROPN_A.	Middle initials don't inflect or compound
PROPN_AAKKOSELLISUUS	s stem, s : de variations back harmony
PROPN_AAKKOSTAMINEN	nen stem, nen : se variations back harmony
PROPN_AALLOT	llot stem, llot : lto variations
PROPN_AARRE	rre stem, rre : rtee variations back harmony
PROPN_AARTO	rto stem, rto : rro and rto variations
PROPN_ACRO_AA	acronyms ending in 'a' pronounced as a letter
PROPN_ACRO_DOLLARI	acronyms ending in a word that inflects like ‘dollari’, i:e type stem
PROPN_ACRO_EE	acronyms ending in 'b', 'c', 'd', 'e', 'g', 'p', 'v', 'w' or 't' pronounced as a letter
PROPN_ACRO_II	Acronyms that end in 'j' or 'i' pronoynced as letter
PROPN_ACRO_KAHDEKSAN	acronyms ending in 8
PROPN_ACRO_KAKSI	acronyms ending in 2
PROPN_ACRO_KOLME	acronyms ending in digit 3 pronounced as number
PROPN_ACRO_LEHTI	acronyms ending in a word that inflects like ‘lehti’, i:e type stem
PROPN_ACRO_METRI	acronyms ending in a word that inflects like ‘metri’, i:e type stem
PROPN_ACRO_NELJÄ	acronyms ending in 4
PROPN_ACRO_NOLLA	acronyms ending in digit 0 pronounced as a number
PROPN_ACRO_OO	Acronyms that end in 'h', 'k' or 'o' that is pronounced as a letter
PROPN_ACRO_PUNTA	acronyms ending in a word that inflects like ‘punta’, a:0 type stem
PROPN_ACRO_SEITSEMÄN	acronyms ending in 7
PROPN_ACRO_UU	acronyms that end in 'q', or 'u' pronounced as a letter
PROPN_ACRO_VIISI	acronyms ending in digit 5 pronounced as number
PROPN_ACRO_YHDEKSÄN	acronyms ending in 9
PROPN_ACRO_YKSI	acronyms ending in 1
PROPN_ACRO_YY	Acronyms that ends in 'y' pronounced as letter
PROPN_ACRO_ZET	Acronyms that end in 'z' pronounced as letter
PROPN_ACRO_ÄKS	Acronyms that ends in 'f', 'l', 'm', 'n', 'r', 's', 'š' or 'x' pronounced as a letter
PROPN_ACRO_ÖÖ	Acronyms that end in 'ö' pronounced as letter
PROPN_AHDET	det stem and
PROPN_AHTO	to stem, to : do ~ to variations
PROPN_AIVOKUOLLUT	llut stem, llut : llee variations
PROPN_AIVOT	ot stem, ot : o variations
PROPN_AJATAR	tar stem, tar : ttare variations
PROPN_ALKU	ku stem, ku : u variations
PROPN_ALLAS	llas stem, llas : ltaa variatons
PROPN_ALTIS	Proper noun, is stem, is : ii variation, back harmony
PROPN_APE	pe stem, pe : ppee variations
PROPN_APU	pu stem, pu : vu variations
PROPN_ARISTOTELES	es stem, es : ee variaitons back hrmony
PROPN_ARKI	ki stem, ki : je variaitons back harmony
PROPN_ASEMA	a stem, a : 0 variations
PROPN_ASKAR	ar stem, ar : aree variaitons
PROPN_ASTE	e stem, e : ee variations
PROPN_ASU	u stem, no variations
PROPN_ASUKAS	kas stem, kas : kkaa variations
PROPN_ATERIMET	Proper noun plurale tantum met stem, met : n variation back harmony
PROPN_AULANKO	nko stem, nko : ngo ~ nko variations
PROPN_BEIGNET	consonat stem, ’ inflections
PROPN_BERNIE	ie stem, no variations front harmony
PROPN_BESSERWISSER	consonant stem, X : Xe varioants
PROPN_BESSET	consonat stem, ’ and i stem inflections
PROPN_BIAUDET	consonat stem, ’ and i stem inflections
PROPN_BIDEE	ee stems ee : e variaotns
PROPN_BIKINIT	it stem, plurale tantum
PROPN_BORDEAUX	consonant stem, ’ inflection
PROPN_BOTSWANA	a stems, a : o and a : 0 variations
PROPN_BRASSERIE	e stem no variatons back harmony
PROPN_BRIE	e stem front harmony
PROPN_BROOKLYN	consonant stem, no variations both harmonies
PROPN_BÉBÉ	é stem 
PROPN_CAMUS	consonat stem, ’ inflection
PROPN_CEP	inflects both normally and as an acronym ending in P or such
PROPN_CERN	inflects both normally and as an acronym ending in N or such
PROPN_CHACHACHA	no variatiosn 
PROPN_COMPOUND	bound proper noun particles, usually, hyphen, such as ‘Etelä-’
PROPN_COWBOY	y stem, no variations both harmonies
PROPN_CROIX	consonant stem, ’ and i stem inflections both harmony
PROPN_DIMITRIS	is stem,  is : ii variations front harmony
PROPN_EDDIE	ie stem, large allomorph set
PROPN_EKKE	Proper noun, kke stem, kke : ke variations
PROPN_ELIAS	as stem, as : aa ~ akse variaitons back hrmony
PROPN_ELIN	in stem, n : me variostna front harmony
PROPN_ELIS	s stem, s : i ~ kse variaitons back hrmony
PROPN_ELÄMÄ	ä stem, ä : 0 varionts
PROPN_EPÄILTY	lty stem, lty :lly variaoitns
PROPN_ESQUIMAU	o stem no variotatnos
PROPN_EUGENE	e stem back harmony
PROPN_FARKUT	ku stem plurale tantum
PROPN_FARMARIT	it stem plurale tantum
PROPN_FIFA	Proper noun initialisms treated like word inflecting like NOUN_OMENA
PROPN_FONDUE	ue stem, no variations both harmonies
PROPN_FRANCIS	s stem, s : si ~ kse variations back harmony
PROPN_FUUG	inflects both normally and as an acronym ending in N or such
PROPN_FÄNRIKIT	it stem, it : e varioations
PROPN_GALILEO	o stem no variations all allomorphs
PROPN_GAY	y stem, both harmonies
PROPN_HAAKSI	ksi stem, ksi : ht varioants
PROPN_HAI	i stem, i : 0 variations
PROPN_HAIT	Plural-only proper noun, monosyllabic ai stem
PROPN_HAMMAS	mas stem, mas : mpaa variations
PROPN_HAPPI	ppi stem, ppi : pe variations
PROPN_HAPPO	ppo stem, ppo : po variations
PROPN_HEATHROW	Proper noun w, consonant stem inflection, ’ and i stem
PROPN_HEITIN	tin stem, tin : ttime variations front harmony
PROPN_HELLE	optional lte : lle gradation
PROPN_HELPI	optional lpi : lvi gradation
PROPN_HENKI	nki stem, nki : nge variations
PROPN_HEPO	po stem, po : vo variations
PROPN_HERAKLES	es stem, es : ee and es : esin variaitons back hrmony
PROPN_HIIRI	i stem, i : e variations and consonant stems
PROPN_HIRTTO	tto stem, tto : to variations
PROPN_HIUTALEET	eet stem, eet : e variations plurale tantum back harmony
PROPN_HKI	Abbreviated Helsinki inflects like *Hki* : *Hgissä*
PROPN_HONKA	nka stem, nka : ng variations
PROPN_HOPEAT	eat stem, eat : e variations plurale tantum
PROPN_HORTA	 rta stem, rta:rr variations
PROPN_HORTE	optional te : ttee gradation
PROPN_HOSIKE	allomorphs
PROPN_HOUSUT	ut stem no variations plurale tantum
PROPN_HUIKU	optional ku : u gradation
PROPN_HUOLITELTU	ltu stem, ltu : llu variations
PROPN_HUPI	pi stem, pi : ve variations
PROPN_HYLKY	ky stem, ky : y variations
PROPN_HYRKÄS	optional käs : kkää gradation
PROPN_HYÖKY	optional ky : y gradation
PROPN_HYÖTYY	yy stem, yy : y variations
PROPN_HÄIRIÖ	ö stem no variations
PROPN_HÄKKI	kki  stem, kki : ke variations front harmony
PROPN_HÄKKYRÄ	ä stem, ä : ö variastions
PROPN_HÄMET	et stem
PROPN_HÄMMINKI	nki stem, nki : nge variations
PROPN_HÄNNÄT	Plural-only proper nouns, nnät:ntä variations
PROPN_HÄNTÄ	with ntä stem, ntä : nn variations
PROPN_HÄRKIN	in:ime stems front harmony
PROPN_HÄÄT	äät stem, plurale tantum
PROPN_HÄÄTÖ	tö stem, tö : dö variation
PROPN_HÖLKKÄ	kkä stem, kkä : k variaitns
PROPN_HÖPÖTTÄJÄ	ä stem, ä : 0 variations
PROPN_HÖYHENET	et stem, et : 0 variations, front harmony, plurals
PROPN_INDIEGOGO	o stem no variations all allomorphs
PROPN_INDIEGOGO	on and hon illatives
PROPN_INGET	Plural-only proper noun, i:e stem, nk:ng gradation
PROPN_INKA	optional nka : nga gradation
PROPN_ITÄMAAT	aat stem, aat : a variations plurale tantum
PROPN_JALTA	optional lta : lla gradation
PROPN_JEPPE	pe stem, ppe: pe variations
PROPN_JOCKEY	y stem no variations, both harmonies
PROPN_JOUKOT	Proper noun, kot stems, kot : o variations plurale tantum
PROPN_JOUTSEN	consonant stems, X : xe variations
PROPN_JUHLAT	at stem, at : 0 variations plurale tantum
PROPN_JULKU	optional ku : u gradation
PROPN_JUOVAT	proper nouns, vat stem, at : p variations plurale tantum
PROPN_JYLKYT	kyt stem, kyt : y variations Plurals only
PROPN_JÄRJESTÖT	öt stem, öt : ö variations plurale tantum
PROPN_JÄRKI	ki stem, ki : je variations
PROPN_JÄRVITAHDON	tahdon stem
PROPN_JÄÄTELÖ	ö stem no variations
PROPN_KAARET	Plural-only proper nouns, i:e stem, kk:k gradation
PROPN_KAARRET	Plural-only proper nouns, i:e stem, kk:k gradation
PROPN_KAARROT	Plural-only proper nouns, i:e stem, kk:k gradation
PROPN_KALATOIN	toin stem, toin : tome variaitons, archaic
PROPN_KANAALI	i stems, i:E variations
PROPN_KANGAS	ngas stems, ngas:nkaa variations
PROPN_KANGASALA	a stems, a : o variation and a : 0 for adessive
PROPN_KANKAHAT	Plural-only proper nouns, nkahat stems, nka : ngas variations
PROPN_KANNEL	nel stem, nel : nele : nelee variaitons
PROPN_KARRAT	Plural-only proper nouns, at stems, a : o variatiosn
PROPN_KASTANJETIT	tit stems, tit : ti variations plurale tantum
PROPN_KASTIKE	ke stem, ke : kkee variationsa
PROPN_KASTILJAT	Plural-only proper nouns, at stem, at : o variations
PROPN_KAUSI	si stem, si : te variations
PROPN_KEHVELI	i stem, i :e variations front harmony
PROPN_KENGÄT	ngät stem, ngät : nk variations
PROPN_KENKÄ	Proper nouns wit nkä stem, nkä : ng variatiosn
PROPN_KENTTÄ	ttä stems, ttä : t variations
PROPN_KERITSIMET	imet stem, imet : in variations plurale tantum
PROPN_KERTA	rta stem, rta :rra variations
PROPN_KEVÄT	ät stem, ät : ää variations
PROPN_KIDE	de stem, de : tee variatisotn front harmony
PROPN_KIELTO	lto stem, lto : llo variations
PROPN_KIERRE	rre stem, rre : rtee variations
PROPN_KIHARAT	at stem, at : o variations plurale tantum
PROPN_KIINNE	nne stem, nne : ntee variations
PROPN_KILPI	pi stem, pi : ve variations
PROPN_KIRITTÄRET	Plural-only proper noun, ttäret stems, ttäret : tär variations
PROPN_KIRJA	a stem, a : o variations
PROPN_KIRVES	es stem, es : ee variations front harmn y
PROPN_KITARA	a stem, a : o variations
PROPN_KIVI	i stem, i : e variations
PROPN_KIVILAMPI	mpi stem, mpi : mm variation back harmony
PROPN_KIVILAMPI	opitional mpi : mmi  gradation
PROPN_KLUMPIT	Plural-only proper noun, pit stem, pit : ppi variations
PROPN_KOE	e stem, e : kee variatins back harmony
PROPN_KOKO	koko stem,  ko : oo : o : ’ o variations
PROPN_KOMPA	mpa stem, mpa : mm variations
PROPN_KORPI	pi stem, pi : ve variations
PROPN_KORTES	tes stme, tes : ttee variations
PROPN_KORTET	tet stem and
PROPN_KORTTI	tti stems, tti:te
PROPN_KORVET	Plural-only proper noun, et stem, vet : pi variations
PROPN_KOUVOT	Plural-only proper noun, ot stem, ot : o variations
PROPN_KREUS	proper nouns, s stem, s : 0 ~ ks variations
PROPN_KUITU	tu stem, tu : du variations
PROPN_KUMMUT	Plural-only proper nouns, mmut stem, mmut : mpu variations
PROPN_KUNGFU	u stem, no variations
PROPN_KUNNAT	Plural-only proper nouns, nnat stem, nnat : nta variations
PROPN_KUNTA	nta stem, nta : nn variations
PROPN_KUOPAT	pat stem, pat : ppo variations plurale tantum
PROPN_KUOPPA	ppa stem, ppa : po variations
PROPN_KUPPI	Proper nousn, ppi stem, ppi : pe variations
PROPN_KUTSUNTA	nta stem, nta : nno variations
PROPN_KUULOKKEET	kkeet stems, kkeet : ke variations plurale tantums
PROPN_KUUS	kuus stem, s : te variations
PROPN_KYDÖT	Plural-only proper noun, döt stem, döt : tö variations
PROPN_KYKY	yky stem, yky : yvy variations
PROPN_KYLKIÄINEN	nen stems, nen : se variations front harmony
PROPN_KYLÄNVANHIN	in stems, in : imma variations, mostly compound names ending superlatives
PROPN_KYNNET	Plural-only proper nouns, nnet stem, nnet : nsi variations
PROPN_KYNNÄÄT	Plural-only proper noun, nnäät stem, nnäät : näs variations
PROPN_KÄKI	ki stem, ki : e variations
PROPN_KÄMMEKKÄ	kkä stem, kkä : kö variations
PROPN_KÄPY	py stem, py :vy variations
PROPN_KÄPÄLÄ	ä stem, ä : 0 variations
PROPN_KÄRJET	Plural-only proper nouns, et stem, jet: ki variations
PROPN_KÄRRY	y stem no variations
PROPN_KÄRSÄKÄS	käs stem, käs : kkää variations
PROPN_KÄRÄJÄT	Plural-only proper nouns, ät stem, ät : 0 variations
PROPN_KÄSITE	te stem, te : ttee variations front harmony
PROPN_KÄÄNTÖ	ntö stem, ntö : nnö variations
PROPN_KÖNGÄS	ngäs stem, ngäs : nkää variations
PROPN_KÖYHYYS	s stem, s : de variations front harmonu
PROPN_KÖYSI	si stem, si : de variations front harmony
PROPN_KÖÖ	öö stem, öö : ö variations
PROPN_LAET	Plural-only proper nouns, et stem, et : ki variations
PROPN_LAHDET	Plural-only proper nouns, det stem, det : ti variations
PROPN_LAHELMA	both a : o and a : 0 stems
PROPN_LAHTI	ti stem, ti : de variations
PROPN_LAIDUN	dun stem, dun : tume variations
PROPN_LAKI	ki stem, ki : i variations
PROPN_LAMMET	Plural-only proper nouns, mmet stem, mmet : mpi variations
PROPN_LAMMI	Plural-only proper nouns, mmi stem, mmi : mp variatiosn
PROPN_LAMMIT	Plural-only proper nouns, mmit stem, mmit : mp variations
PROPN_LANKA	nka stem, nka : ngo variations
PROPN_LANNET	Plural-only proper nouns, nnet stem, 
PROPN_LASIT	it stem, it : e variations plurale tantum
PROPN_LEHDET	det stem, det: ti variations
PROPN_LEHTI	ti stem, ti : de variaons
PROPN_LEIKKUU	uu stem, uu : u variations
PROPN_LEIPÄ	pä stem, pä : v variations
PROPN_LEIVANTI	optional nti : nni gradation
PROPN_LENTTEE	ee stem, ee : variaitons
PROPN_LEPAKKO	kko stem, kko : ko variations
PROPN_LEVIS	both s : kse and s : si inflections
PROPN_LIEMI	mi stem, mi : n variations
PROPN_LIITTOUTUNEET	nneet stem, nneet : nut variations plurale tantum
PROPN_LIIVIT	it stem, it : i variations plurale tantum
PROPN_LINGOT	Plural-only proper nouns, ngot stem, ngot : nko variations
PROPN_LINTU	ntu stem, ntu : nnu variations
PROPN_LIPEÄ	eä stem, eä : e variations
PROPN_LIPOTTARET	Plural-only proper noun, ttaret stem, ttaret : tar variations
PROPN_LIPPU	ppu stem, ppu : pu variations
PROPN_LIUKU	uku stem, uku : u’u variations
PROPN_LIVVADIEVÁT	át stem
PROPN_LOKA	ka stem, ka : 0 variations
PROPN_LOKKI	kki stem, kki : ke variations
PROPN_LOMMOL	mmol stem and
PROPN_LOTTE	tte stem, tte : te variations back harmony
PROPN_LOUET	Plural-only proper noun, uet stem, 
PROPN_LUHDAT	Plural-only proper nouns dat stem, dat : ta variations
PROPN_LUKU	uku stems, uku : uvu variations
PROPN_LUMME	mme stem, mme : mp variations
PROPN_LUODE	de stem, de : tee variations
PROPN_LUODES	des stem, des : tee variations
PROPN_LUOKKA	kka stem, kka : k variations
PROPN_LUOLIKOT	Plural-only proper noun, kot stem, kot : kko variaitnos
PROPN_LUPA	pa stem, pa : va variations
PROPN_LUSIKKA	kka stem, kka : ko variations
PROPN_LÄHDES	des stem, des : tee variations front hrmony
PROPN_LÄHDET	Plural-only proper noun, det stem, 
PROPN_LÄHIN	in stem, in : immä variations, front harmony
PROPN_LÄNSI	nsi stem, nsi : nne variations front harmony
PROPN_LÄÄKE	ke stem, ke : kkee variations front harmony
PROPN_LÖPÖ	Proper nouns pö stem, pö : vo variations 
PROPN_MAA	aa stem, aa : a variations
PROPN_MAJ	j stems 
PROPN_MAKKARA	a stems, a : o variations 
PROPN_MAKU	ku stem, ku : u variatons
PROPN_MALKO	ko stem, lko : o variations
PROPN_MALMÖ	ö stem no variations, hön illative
PROPN_MANNER	ner stem, ner : tere : teree variations bck harmony
PROPN_MARIE	some allomorphs
PROPN_MARKKINAT	at stem, at : a variations plurale tantum
PROPN_MATEE	ee stem, ee : e variatons
PROPN_MATKUET	Plural-only proper nouns, uet stems, 
PROPN_MC	proper noun bound particle, mostly foreign surname prefixes, compounds, propers without hyphen
PROPN_MERI	meri stem, consonant stem partitive tä
PROPN_MERTU	rtu stem, rtu : rru variations
PROPN_METTE	tte stem, tte:te variations front harmony
PROPN_MIEHET	Plural-only proper noun, het stem, het : s variations
PROPN_MIELENGE	Proper nouns nge  stem, nge : nke variations
PROPN_MIELLE	lle stem, lle : ltee variations
PROPN_MIES	mies stem, s : he variations
PROPN_MINERVA	both a : o and a: 0 stems
PROPN_MITTA	tta stem, tta : to variations
PROPN_MONSIEUR	consonant stem, ’ inflections both harmony
PROPN_MULTA	lta stem, lta : ll variations
PROPN_MURTEET	Plural-only proper noun, rteet stem, rteet : rre variatons
PROPN_MYRKKY	kky stem, kky : ky variations
PROPN_MÄET	Plural-only proper nouns, et stem, et : ki variatons
PROPN_MÄNNYT	Plural-only proper noun, nyt stem, nnyt : nty variations
PROPN_MÄNTY	nty stem, nty : nnyt variations
PROPN_MÄTTÄÄT	Plural-only proper noun, ttäät stem, ttäät : täs variations
PROPN_MÖMMÖ	ö stem no variations
PROPN_MÖRKÖ	kö stem, kö : ö variations
PROPN_NAHKA	ka stem, optional ka : a gradaitons
PROPN_NALLE	e stem, no variations back harmony
PROPN_NATO	both word and acronym inflections
PROPN_NEITSYT	yt stem, yt : ye variations
PROPN_NEUVOTTELUT	ut stem, ut : u variations
PROPN_NG	Vowelless foreign proper nouns, tentatively inflects like zen, punk
PROPN_NIEMET	Plural-only proper noun, met stem, met : mi variations front harmony
PROPN_NIHTI	ti stem, ti : de variations
PROPN_NIITUT	Plural-only proper nouns, tut stem, tut : ttu variatons
PROPN_NIITYT	Plural-only proper nouns, tyt stem, tyt : tty variations
PROPN_NIMETÖIN	old caritive töin stems, töin : tömä variations
PROPN_NIMETÖN	tön stem, tön : tömä variations
PROPN_NISSE	e stem, no variations front harmony
PROPN_NOKI	ki stem, ki : e variaqtions
PROPN_NOUGAT	consonant stem, ’ inflections
PROPN_NUGAA	aa stems, aa : a variations
PROPN_NUKKE	Proper noun, kke stems, kke : ke ariations back harmony
PROPN_NÄLKÄ	kä stems, kä : 0 variatins
PROPN_OIVE	optional ve : pe gradation
PROPN_OLUT	t stem, t : e variations
PROPN_ONKI	nki stem, nki : ng variaotns
PROPN_ONNET	Plural-only proper et stems, et : i variaotns
PROPN_ONNI	i stems, i : e variaotns
PROPN_OOKOO	oo stems, oo : o variations
PROPN_OPINNOT	not sten, nnot : nto variations 
PROPN_OSATON	ton stem, ton : ttoma variatons
PROPN_OSOITE	te stem, te : ttee variations back harmony
PROPN_PAIKAT	kat stem, kat : kk variations
PROPN_PANKIT	Plural-only proper noun, kit stem, kit : kke variontoa
PROPN_PARFAIT	consonant stem, ’ inflections
PROPN_PATA	ta stem, ta : do variatons
PROPN_PATEE	ee stem, ee : e variations
PROPN_PATSAS	as stem, as : aa variatino
PROPN_PEIPOT	Plural-only proper noun, pot stem, pot :ppo variations
PROPN_PELKO	ko stem, ko : o variations
PROPN_PELTI	lti stem, lti : lle variations
PROPN_PENGER	nger stem, nger : nkeree variaotns
PROPN_PIDOT	dot stem, dot : to variation
PROPN_PII	ii stem, ii : i varionts
PROPN_PIIROA	oa stems, oa : o variaotns
PROPN_PIPPALOT	ot stems, ot : o variations
PROPN_PISTE	e stem, e : ee variations front harmony
PROPN_POHATTA	tta stem, tta : tto variations
PROPN_POHJE	je stem, je : kee variations
PROPN_POIKA	poika stem, ika : j variations
PROPN_POJAT	Proper nouns  wiht pojat stem, jat : ika variaoitns plurale tantum
PROPN_POLITIIKKA	kka stem, kka : ko variations
PROPN_PONSI	nsi stem, nsi : nne variations
PROPN_PORRAS	ras stem, rras : rtaa variaitno
PROPN_PORTAAT	Proper nouns rtaat stem, rtaat : rras variations
PROPN_PROBLEEMA	a stem, a : o ~ 0 variations
PROPN_PUHELIN	n stem, n : me variations back harmony
PROPN_PUNK	consonant stem, X : Xe variations back harmony
PROPN_PUU	uu stem, uu : u varioatns
PROPN_PUUT	uut stem, uut : u variations plurale tantum
PROPN_PYHTÄÄ	ää stem,  ää : 0 vatiatons
PROPN_PYTTY	ty stem, tty : ty variations
PROPN_PYY	yy stem, yy : y varioatns
PROPN_PÄÄ	ää stem, ää : ä variations
PROPN_PÖKSYT	yt stem, yt : y variations plurale tantum
PROPN_PÖLHÄÄT	Plural-only proper noun, äät stem, äät : äs variation
PROPN_PÖLLÖT	Plural-only proper noun, öt stem, öt : ö variations
PROPN_PÖNTTÖ	ttö stme, ttö : tö variations
PROPN_PÖYTÄ	tä stem, tä : d variations
PROPN_RAGUU	uu stem, uu : u variations
PROPN_RAKENNE	nne stem, nne : ntee variatons back harmony
PROPN_RAMPA	mpa stem, mpa : mma variations
PROPN_RANGAT	Plural-only proper noun, ngat stem, ngat : nka variations
PROPN_RANNAT	Plural-only proper noun, nnat stem, nnat : nta variatinos
PROPN_RAPPE	ppe stem, ppe : pe variaiton front harmony
PROPN_RAPPUSET	set stem, set :nen variations back harmony plurale tantum
PROPN_RAPUT	put stem, put : ppu variations plurale tantum
PROPN_RATAS	tas stem, tas : ttaa variatons
PROPN_RAUDAT	dat stem, dat : ta variation plurale tantmu
PROPN_RAUNIOT	ot stem, ot : o variations
PROPN_RAVUT	Plural-only proper noun, vut stem, vut : pu variations
PROPN_REGGAE	e stem, no variations back harmony
PROPN_REIKÄ	ikä stem, ikä : i’i variation
PROPN_REIÄT	Plural-only proper noun, iät stem, iät : ikä variations
PROPN_RENKAAT	kaat stem, kaat : gas variation plurale tantum
PROPN_RIIPI	pi stem, pi : ve variaotns front harmony
PROPN_RIIVET	Plural-only proper nouns, vet stem, vet : pi variations
PROPN_RIMMI	mmi stem, mmi : mpi variations front harmony
PROPN_RIMMIT	Plural-only proper noun, mmit stem, mmit : mp variatins
PROPN_RIMPI	mpi stem, mpi : mmi variation front hrmony
PROPN_RINNET	Plural-only proper noun, nnet stem and
PROPN_RINTEET	Plural-only proper noun, nteet stem, nteet . nne variations
PROPN_RIPE	pe stem, pe : ppee variations
PROPN_RIPSET	et stem, et : i variations front harmony
PROPN_RITA	optional ta : da gradation
PROPN_RIUTAT	Plural-only proper noun, tat stem, tat : tta variations
PROPN_ROITOT	Plural-only proper noun, tot stem, tot : tto variations
PROPN_ROMPAAT	Plural-only proper noun, mpaat stem, mpaat : mmas varioatnont
PROPN_ROPO	optional po : vo gradation
PROPN_ROSÉ	é stem
PROPN_ROTTA	tta stem, tta : t varitions
PROPN_RUIPELO	o stem no variations
PROPN_RUIS	is stem, is : kii variatons bavk harmnoyu
PROPN_RUMPU	mpu stem, mpu : mmu variations
PROPN_RUNKO	nko stem, nko : ngo variations
PROPN_RUOKO	oko stem, oko : o’o variation
PROPN_RUOPPAAT	Plural-only proper noun, ppaat stem, ppaat : pas variations
PROPN_RUUHI	i stem, i : e variation
PROPN_RUUMIS	is stem, is : ii variation back harmony
PROPN_RUUVI	i stem, i : e variation
PROPN_RYPÄS	päs stem, päs : ppää variaitno
PROPN_RYYPPY	ppy stem, ppy : py variations
PROPN_RYYTI	optional ti : di gradation
PROPN_RÄJÄYTYS	s stem, s : ks variations front harmony
PROPN_RÄMEET	Plural-only proper noun, eet stem, eet : e variaotn frtont  harmony
PROPN_RÄMEÄT	Plural-only proper noun, eät stem, eät : e variation
PROPN_RÄMIÄT	Plural-only proper noun, iät stem, iät : i variation
PROPN_SAAPAS	pas stem, pas : ppaa variations
PROPN_SAARET	Plural-only proper nouns, et stem, et : i variaotn back harmony
PROPN_SAINT_TROPEZ	both ’ and i stem inflection
PROPN_SAKSET	Proper noun, et stem, et : i varioatn plurale tantum
PROPN_SALONTEET	Plural-only proper noun, nteet stem, nnteet : nne variatino front hamrony
PROPN_SALPA	lpa stem, lpa : lv variations
PROPN_SAMMALET	Plural-only proper noun, et stem, et : 0 variation back harmony
PROPN_SAMPI	mpi stem, mpi : mm variation back harmony
PROPN_SAMPO	mpo stem, mpo : mmo variations
PROPN_SATU	optional tu : du gradation
PROPN_SAVI	both i and e stems
PROPN_SEIKKAILU	Proper noun u stem, no variations
PROPN_SEIVÄS	Proper noun, väs stem, väs : pää variations
PROPN_SELENE	new e stems, no variatinos front harmmun
PROPN_SELJÄT	Plural-only proper noun, jät stem, jät : kä variatinos
PROPN_SEPPÄ	ppä stem, ppä : pä variation
PROPN_SERGEJ	j stem
PROPN_SERKUKSET	kset stem, kset :s variation back harony
PROPN_SHOW	Proper noun w, consonant stem inflection, ’
PROPN_SIEMEN	consonant stem, X : Xe variaotn front harmony
PROPN_SIIRTO	rto stem, rto :rro variations
PROPN_SIIVILÄ	ä stem, ä : ö variations
PROPN_SILAKAT	kat stem, kat : kka variations
PROPN_SILMÄKKEET	Plural-only proper noun, kkeet stem, kkeet : ke variation front hamrmoby
PROPN_SISÄLTÖ	ltö stem, ltö : llö variations
PROPN_SIUNAAMATTOMAT	Plural-only proper noun, ttomat stema, ttomat : ton varioants
PROPN_SIVISTYNYT	nyt stem, nyt : nee varionts
PROPN_SKEITTI	Proper noun, tti stem, tti : te variations front harmonu
PROPN_SOINTI	nti stem, nti : nne variations
PROPN_SOKEA	ea stem, ea: e variations
PROPN_SOTA	ta stem, ta : d variations
PROPN_SPOTIFY	New proper nouns, back, front harmonies, no stem variations
PROPN_STADION	Proper nound, consonant stem, and X : Xe variations bavk harmny 
PROPN_SUHTEET	teet stem, teet : de variations
PROPN_SUKAT	kat stem, kat : kka variations
PROPN_SULKA	ka stem, ka : a variatons
PROPN_SUODATIN	tin stem, tin : ttime varioants
PROPN_SUOT	Plural-only proper noun, uot stem, uot : o variations
PROPN_SYDÄN	sydän stem, n : me variation and
PROPN_SYLI	i stem, i : e variations
PROPN_SYÖMINGIT	ngit stem, git : nki variations
PROPN_SÄNKY	nky stem, nky :ngy variaitons
PROPN_SÄRKÄT	Plural-only proper noun, kät stem, kät : kkä variaitnsot
PROPN_SÄÄDIN	din stem, din : time variations
PROPN_SÄÄRET	Plural-only proper noun, et stem, et : i varionts
PROPN_SÄÄSKI	both i and e stems
PROPN_TAIMI	mi stem, mi : n varinoats
PROPN_TAIVAL	val stem val : pale : palee variiostn
PROPN_TALKOOT	oot stem, oot : oo variations pluarle tantum
PROPN_TALO	o stem no variations
PROPN_TARVE	ve stem, ve : pe variatinos
PROPN_TAUDIT	dit stem, dit : ti variatino plurale tantun
PROPN_TAUTI	ti stem, ti : de varionts
PROPN_TAVAT	Proper noun xxx vat plurale tantum
PROPN_TEE	Proper noun, ee stem, ee : e variation
PROPN_TEHDAS	das stem, das : ta variations
PROPN_TEHTAAT	Plural-only proper noun, taat stem, taat : das variations
PROPN_TEISTE	both a and tta partitives
PROPN_TEKO	ko stem, ko : o variations
PROPN_TIE	ie stem, ie : e variations front hamronu
PROPN_TIENOO	oo stem, oo : o variaitnos
PROPN_TIETEET	teet stem, teet : de variations plurale tantum
PROPN_TIHVII	ii stem, ii : i variations
PROPN_TIKKAAT	kaat stem, kaat : kas variatinos plurale tantum
PROPN_TIKKU	kku stem, kku : ku variations
PROPN_TIPPA	ppa stem, ppa : po variations
PROPN_TOIMET	et stem aand met : mi variations plureal teantum
PROPN_TOKEE	ee stem, ee : e variations
PROPN_TONGIT	ngit stem, ngit : nk variations plurale tantum
PROPN_TORTTU	ttu stem, ttu : tu variations
PROPN_TOULAT	Plural-only proper noun, at stem, at : a variaton
PROPN_TRIKOO	oo stem, oo : o variations
PROPN_TULI	i stem, i : e variations and consonant ta parititve
PROPN_TUNTO	nto stem, nto : nno variationsy
PROPN_TUOMIO	o stem, no variationys
PROPN_TYTÄR	tär stem, tär : ttäre variations
PROPN_TYTÖT	Proper noun, töt stem, töt : ttö variations plurale tantum
PROPN_TYYLI	i stem, i : e variations fron t harmunå
PROPN_TYYPPI	ppi stem, ppi : pe variation front harmony
PROPN_TYÖ	yö stem, yö : ö variation
PROPN_TYÖTTÖMÄT	Plural-only proper noun, tömät stem a nd tömät : tön
PROPN_TÖLPÄKÖT	Plural-only proper noun, köt stem, köt : kkö stem
PROPN_TÖLPÄT	Plural-only proper noun, pät stem, pät : ppä variatnoy
PROPN_TÖRPPÖ	Proper noun, ppö stem, ppö : pö variations
PROPN_UKKO	ko ste, kko : ko variaitons
PROPN_ULAPPA	ppa stem, ppa : po variaytion
PROPN_UNICEF	both word and acronymb inglections
PROPN_UNTO	optional nto : nno gradations
PROPN_UOTI	optional ti : di gradation
PROPN_VAADIN	din stem, din : time variations
PROPN_VAAKA	aka stem, aka : a’a variations
PROPN_VAANII	ii stem, ii : i variationt
PROPN_VAASAN	non-inflecting proper nouns
PROPN_VAINAA	aa stem, aa : a variations
PROPN_VAKUUTUS	s stem, s : kse variation back harmonu
PROPN_VALJAAT	Proper noun jaat stem, aat: as variations plurale tantu
PROPN_VALLAT	Proper noun, llat stem, llat : lta variation plurale tanum
PROPN_VALTA	lta stem, lta : llo variatin
PROPN_VANHEMMAT	mmat stem, mmat : mp variation plurale tantum
PROPN_VANKI	nki stem, nki : nge variaitnos
PROPN_VARAT	at stem, at  : a variations plurale tanumt
PROPN_VARPAAT	Plural-only proper noun, paat stem, paat :  vas variations
PROPN_VARSI	rsi stem, rsi : rre variationst front harmony
PROPN_VARVAS	vas stem, vas : paa variatins
PROPN_VEHKEILY	y sytem, no variations
PROPN_VEITSI	tsi stem, tsi : s varitatnots
PROPN_VELJET	Plural-only proper noun, jet stem, jet : i varitatnos front harmonu
PROPN_VERSAILLES	consonant stema nd ’ inflecitno
PROPN_VETO	to stem, to : do variations
PROPN_VETY	ty stem, ty : dy variatons
PROPN_VIENTI	nti stem, nti : nne variatinost fron harmony
PROPN_VIHKIÄISET	set stem, set : nen varioants front harmonby
PROPN_VIHKO	optional ko : o gradation
PROPN_VIIRRET	Plural-only proper noun withr rret stem, rret : 
PROPN_VIIS	iis stem, s : de  variatinst front harmony
PROPN_VIIVE	ve stem, ve : pe variations
PROPN_VIKA	ka stem, ka : o variatnos
PROPN_VINKU	nku stem, nku : ngu bvariations
PROPN_VIRSI	rsi stem, rsi :rre variatons  front harmnyt
PROPN_VODĂ	Proper nonus, ǎ stem
PROPN_VOIMA	a stem, a : 0 variatins
PROPN_VON	proper noun particle, no inflection, no compounding, for some foreign surname etc. patronymical constructs
PROPN_VUO	uo stem, uo : o variationst
PROPN_VUODET	det stem
PROPN_VUOLLE	lle stem, lle : ltee variations
PROPN_VUOLLET	Plural-only proper noun, llet stem, llet :
PROPN_VÄRTÖ	rtö stems, rtö : rrö variatons
PROPN_WADA	Proper noun acronyms inflected like a-final noun without a colon, e.g. WADA ~ WADAn. Plurals only, colon.
PROPN_YHTIÖT	Plural-only proper noun, ö stem no variatnos
PROPN_YKSIKKÖ	Proper noun, kkö stem, kkö : kö variaton
PROPN_YLVA	both a :o  adn A : 0variations
PROPN_YLÄNKÖ	Proper noun, nkö stem, nkö : ngö variatno
PROPN_YLÖÖ	öö stem, öö : ö variation
PROPN_YMPÄRYSTÄ	ä stem, ä : 0 variation
PROPN_YRITTÄ	ttä stem
PROPN_YSTÄVYKSET	kste stem, kset : s variation front harmony plurale tantum
PROPN_YÖKKÖ	kkö stem, kkö : kö varioant
PROPN_ZEN	consonant stem, X : Xe variation front hamro u
PROPN_ZOMBIE	e stem, no variations back hamronu
PROPN_ÄYRÄS	äs stem, äs : ää variations
PUNCT_NONSTD_DASH_LOOP	accounts for repeated hyphen-like characters
PUNCT_NONSTD_EXCL_LOOP	accounts for repeated exclamation-like characters
PUNCT_PILKKU	punctuation, rare back inflection plausible
PUNCT_PISTE	punctuation, rare front inflection plausible
SCONJ_ETTÄ	sub-ordinating conjunction, no inflections
SYM_$	symbols, inflection, :, compounding, -
SYM_,	symbol, back inflection, :, compounding, -
SYM_.	symbols, front inflection, :, compounding, -
SYM_CELSIUS	symbols, inflection, :, compounding, -
SYM_GRAMMA	symbols, inflection, :, compounding, -
SYM_JOULE	symbols, inflection, :, compounding, -
SYM_METRI	symbols, inflection, :, compounding, -
SYM_TUOTE	symbols, inflection, :, compounding, -
SYM_WEBER	symbols, inflection, :, compounding, -
SYM_¢	symbols, inflection, :, compounding, -
SYM_£	symbols, inflection, :, compounding, -
SYM_§	symbols, inflection, :, compounding, -
SYM_Ω	symbols, inflection, :, compounding, -
SYM_€	symbols, inflection, :, compounding, -
VERB_AALLOTA	llota stem, llota : ltoa variaton
VERB_AHNEHTIA	tia stem, tia : di variations
VERB_AMPUA	mpua stem, mpua : mmu variations
VERB_ARVAILLA	lla stem, lla : le variations
VERB_ARVATA	ata stem, ata : aa variations
VERB_AUTTAA	ttaa stem, ttaa : to variations
VERB_DIGATA	gata stem, gata : gga variatons
VERB_EHTIÄ	tiä stem, tiä : di variations
VERB_EI	Negation verb ‘ei’ has heteroclitic inflection
VERB_ENTÄÄ	ntää stem, ntää : nnä variations
VERB_ERATA	ata stem, ata : kane variations
VERB_ETUILLA	illa stem, illa : ile variation
VERB_HALAJAA	ajaa stem, defective inflection
VERB_HALJETA	jeta stema, jeta : kea variations
VERB_HALUTA	uta stem, uta : ua variations
VERB_HAPATA	pata stem, pata : ppane variations
VERB_HARPPOA	ppoa stem, ppoa : po variations
VERB_HAUKKOA	kkoa stem, kkoa : ko variations
VERB_HELLITÄ	llitä stem, llitä : ltiä variations
VERB_HELPOTA	pota stem, pota : ppone variations
VERB_HELÄJÄÄ	äjää stem, defective inflection
VERB_HERMOTTUA	ttua stem, ttua : tu  variation
VERB_HERÄTELLÄ	tellä stem, tellä : ttele varitinost
VERB_HIIPUA	pua stem, pua : vu variations
VERB_HIVENTÄÄ	ntää stem, ntää : nnä variations
VERB_HUMALTUA	ltua stem, ltua : llu variaitons
VERB_HUONONTAA	ntaa stem, ntaa : nna variations
VERB_HUUTAA	taa stem, taa : si variations
VERB_HYLJÄTÄ	jätä stem, jätä : kä variations
VERB_HYLKIÄ	kiä stem, kiä : ji variations
VERB_HYPELLÄ	pellä stem, pellä : ppele variaton
VERB_HYPPIÄ	ppiä stem, ppiä : pi variations
VERB_HÄVÄISTÄ	väistä stem, väistä : päise variations
VERB_ILJETÄ	jetä stem, jetä : keä variations
VERB_INNOTA	nnota stem, nnota : nto variations
VERB_IRROTA	rrota stem, rrota : rto variations
VERB_ISÄNNÖIDÄ	öidä stem, öidä : öi ~ öitse
VERB_JAHDATA	data stem, data : taa 
VERB_JOUTAA	taa stem, taa : da : si 
VERB_JUOSTA	sta stem, sta : ks variations
VERB_JYRKETÄ	ketä stem, ketä : kkene variatons
VERB_JÄÄDÄ	ädä stem, ädä : ä variatons
VERB_KAATAA	taa ste, taa : do : si 
VERB_KAIKOTA	kota stem, kota : kkoa variations
VERB_KAIPAELLA	paella stem, paella : paile 
VERB_KAIVATA	ata stem, ata : aa variatoins
VERB_KALPPIA	ppia stem, ppia : pi variations
VERB_KAMMETA	mmeta stem, mmeta : mpe variations
VERB_KANTAA	ntaa stem, ntaa : nna variations
VERB_KARHETA	eta stem, eta : enee variationys
VERB_KARHUTA	uta stem, uta : ua variations
VERB_KASVAA	aa stem, aa : o variations
VERB_KATSOA	The regular o stem, dialectally gradating ts variations
VERB_KAUNISTUA	u stem, no variations
VERB_KAVETA	veta stem, veta : pene variations
VERB_KERETÄ	retä stem, retä : keä variations
VERB_KERITÄ	itä stem, itä : kiä variations
VERB_KIERTYÄ	rtyä stem, rtyä : rry variations
VERB_KIETOA	toa stem, toa : do variations
VERB_KIHERRELLÄ	rrellä stem rrellä : rtele variations
VERB_KIILLELLÄ	llellä stem, llellä : ltele variationys
VERB_KIINNETÄ	nnetä stem, nnetä : nteä variations
VERB_KANNETA	nneta stem, nneta : ntea variations
VERB_KIITÄÄ	tää stem, tää : dä : si variations
VERB_KIRVOTA	vota stem, vota : poa variatons
VERB_KIVETTYÄ	ttyä stem, ttyä : ty variations
VERB_KIVETÄ	vetä stem, vetä : veä variations
VERB_KIVISTÄÄ	stää stem, 
VERB_KIVUTA	uta stem, uta : ua variations
VERB_KOMENNELLA	nnella stem, nnella : ntele variations
VERB_KONTIA	ntia stem, ntia : nni variationst
VERB_KOPIOIDA	oida stem, oida : oi variations
VERB_KORVETA	veta stem, veta : peaa variationst
VERB_KOSIA	sia stem, no vatiation
VERB_KOUKUTA	kuya sytem, kuta : kkua variations
VERB_KUHERTAA	rtaa stem, rtaa :rra variatons
VERB_KUKKIA	kkia stem, kkia : ki variations
VERB_KUMMUTA	mmuta stem ammuta :mpua variatoins
VERB_KUTEA	tea stem, tea : de varoatopmst
VERB_KYNTÄÄ	ntää stem, ntää : nnä variatnos
VERB_KYTKEÄ	keä stem, tkeä : tk
VERB_KÄRKKYÄ	kkyä stem, kkyä : ky variatonsy
VERB_KÄYDÄ	ydä stem, ydä : v variations
VERB_KÄÄNNELLÄ	nnellä stem, nnellä : ntele variations
VERB_LASSOTA	ssota stem, oa variations
VERB_LEIKELLÄ	kellä stem, kellä : kkele variations
VERB_LEPPYÄ	ppyä stem, ppyä : py variations
VERB_LEPÄILLÄ	illä stem, illä : ile variations
VERB_LEUDOTA	dota stem, dota : toa variations
VERB_LEVÄTÄ	vätä stem, vätä : pää variatons
VERB_LIIDUTA	duta stem, duta : tua variations
VERB_LOBATA	bata stem, bata : bbaa variations
VERB_LOITOTA	tota stem, tota : ttoa variatoins
VERB_LOPPUA	ppua stem, ppua : pu variations
VERB_LOTOTA	tota stem, tota : toa variatoins
VERB_LUNTATA	tata stem, tata : ttaa variations
VERB_LUUTUTA	tuta stem, tuta : ttua variations
VERB_LÄHTEÄ	hteä stem, hteä : hde : ks variations
VERB_LÄMMETÄ	metä stem, mmetä : mpeä variations
VERB_LÄMMITÄ	mitä stem, mmitä : mpiä variations
VERB_LÄNTÄTÄ	tätä stem, tätä : ttä variatoins
VERB_MARISTA	sta stem, sta : se variations
VERB_MAUKUA	ukua stem, ukua : u’u variations
VERB_MELLAKOIDA	oida stem, oida : oi : oitse variatoins
VERB_MENNÄ	nnä stem, nnä : ne variations 
VERB_MERKITÄ	tä stem, tä : tse variations
VERB_MIELTYÄ	ltyä stem, ltyä : lly variations
VERB_MIETTIÄ	ttiä stem, ttiä : ti variations
VERB_MOITTIA	ttia stem, ttia : ti variations
VERB_MOJAHTAA	taa stem, taa : di variations
VERB_MORKATA	kata stem, kata : kkaa variations
VERB_MULLATA	lata stem, llata : lta variations
VERB_MUODOTA	dota stem, dota : toa variations
VERB_MUTRISTAA	taa stem, taa : ti variations
VERB_MYYDÄ	ydä stem, ydä : 0 variations 
VERB_MÄDÄTÄ	dätä stem, dätä : täne variations
VERB_MÄIKYÄ	kyä stem, kyä : y variations
VERB_MÖNKIÄ	nkiä stem, nkiä : ngi variations
VERB_NAKELLA	kella stem, kella : kkele variations
VERB_NAKERRELLA	rrella stem, rrella : rtele variations
VERB_NIUKETA	keta stem, keta : kkene variations
VERB_NUOKKUA	kkua stem, kkua : ku variations
VERB_NÄHDÄ	hdä stem, hdä : e variations
VERB_NÄPERTÄÄ	rtää stems, rtää : rrä variations
VERB_OLLA	‘olla’ has heteroclitic inflection, lot of common short forms in standard spoken Finnish
VERB_OMMELLA	mmella stem, mmella : mpele variations
VERB_ONKIA	nkia stem, nkia : ngi variations
VERB_PALKITA	ta stem, ta : tse variation
VERB_PANNA	nna stem, nna : ne variations
VERB_PEITOTA	tota stem, tota : ttoa variations
VERB_PENKOA	nkoa stem, nkoa : ngo variations
VERB_PIDETÄ	detä stem, detä : tene variations
VERB_PIERRÄ	rrä stem, rrä : re variations
VERB_PIESTÄ	stä stem, stä : kse variations
VERB_PINGOTA	ngota stem, ngota : nkoa variations
VERB_POIKETA	keta stem, keta : kkea variations
VERB_POLKEA	kea stem, kea : je variations
VERB_PUKEA	kea stem, kea : e variations
VERB_PULPUTA	puta stem, puta : ppua variations
VERB_PUNOA	oa stem, oa : o variations
VERB_PURKAA	kaa stem, kaa : a variations
VERB_PUSERTUA	rtua stem, rtua : rru variations
VERB_PYYTÄÄ	tää stem, tää : si variations
VERB_PÄTEÄ	teä stem, teä : di variations
VERB_RAAPIA	pia stem, pia : vi variations
VERB_RAIKAA	kaa stem, defective inflection
VERB_RANGAISTA	gaista stem, gaista : kaise variations
VERB_RENNOTA	nnota stem, nnota : ntoa variations
VERB_REVETÄ	vetä stem, vetä : peä variations
VERB_RIIPIÄ	piä stem, piä : vi variations
VERB_ROHJETA	jeta stem, jeta : ke variations
VERB_ROHTUA	tua stem, tua : du variations
VERB_RYNNÄTÄ	nnätä stem, nnätä variations
VERB_RYPEÄ	peä stem, peä : ve variations
VERB_RYSKIÄ	kiä stem, no variatiosn
VERB_RYÖPYTÄ	pytä stem, pytä : ppyä variations
VERB_RÄPSYTTÄÄ	ttää stem, ttää : ti variations
VERB_SAADA	ada stems, ada : 0 variations
VERB_SAARTAA	rtaa stems, rtaa : rra variations
VERB_SAMMOTA	mmota stems, mmota : mpoa variations
VERB_SATAA	taa stem defective inflection
VERB_SELVITÄ	vitä stem, vitä : piä variations
VERB_SIEPATA	pata stem, pata : ppaa variations
VERB_SILIYTYÄ	ytyä stem, ytyä : ydy variations
VERB_SILPOA	poa stem, poa : vo variations
VERB_SIVALTAA	ltaa stem, ltaa : lla variations
VERB_SI’ITÄ	’itä stem, ’itä : kiä variations
VERB_SORTAA	rtaa stem, rtaa : rra variations
VERB_SOTKEA	ea stem, ea : i variations
VERB_SULATELLA	tella stem, tella : ttele variations
VERB_SUPETA	peta stem, peta : ppene variations
VERB_SURRA	rra stem, rra : re variations
VERB_SUUNNATA	nnata stem, nnata : ntaa variations
VERB_SYÖDÄ	yödä stem, yödä : öi variations
VERB_SYÖPYÄ	pyä stem, pyä : vy variations
VERB_SÄILÖÄ	öä stem, no variations
VERB_SÄPSÄHDELLÄ	dellä stem, dellä : tele variations
VERB_SÄRKEÄ	keä stem, keä : je variations
VERB_SÖRKKIÄ	kkiä stem, kkiä : ki variations
VERB_TAITAA	taa stem, taa : da : si variations
VERB_TAKOA	koa stem, koa : o variations
VERB_TAPELLA	pella stem, pella : ppele variations
VERB_TAPPAA	ppaa stem, ppaa : po variations
VERB_TEMMATA	mmata stem, : mmata : mpaa variations
VERB_TEMPOA	mpoa stem, mpoa : mmo variations
VERB_TIETÄÄ	tää stem, tää : si variations
VERB_TIPAHDELLA	della stem, della : tele variations
VERB_TODETA	deta stem, deta : tea variations
VERB_TUIKKAA	kkaa stem, kkaa : ki variations
VERB_TULLA	lla stem, lla : le variations
VERB_TUNGETA	ngeta stem, ngeta : nkea variations
VERB_TUNKEA	nkea stem, nkea : nge variations
VERB_ÄNKEÄ	nkeä stem, nkeä : nge variations
VERB_TUNTEA	ntea stem, ntea : nne variations
VERB_TUODA	uoda stem, uoda : oi variations
VERB_TYHJENTYÄ	ntyä stem, ntyä : nny variations
VERB_TYLPETÄ	petä stem, petä : ppene variations
VERB_TYMPIÄ	mpiä stem, mpiä : mmi variations
VERB_TÄHDÄTÄ	dätä stem, dätä : tää variations
VERB_TÄHYTÄ	tä stem, tä : si variations
VERB_ULOTA	ota stem, ota : kone variations
VERB_UPOTA	pota stem, pota : ppoa variastions
VERB_VAAHDOTA	dota stem, dota : toa variations
VERB_VAELLELLA	llella stem, llella variations
VERB_VAKAANTUA	ntua stem, ntua : nnu variations
VERB_VARTOA	rtoa stem, rtoa : rro variations
VERB_VAVISTA	vista stem, vista : pisee variations
VERB_VERRATA	rrata stem, rrata : rta variations
VERB_VIEDÄ	iedä stem, iedä : ei variatons
VERB_VIEROITTAA	ttaa stem, ttaa : ta variations
VERB_VIHELTÄÄ	ltää stem, ltää : llä variations
VERB_VIITTOA	ttoa stem, ttoa : to variations
VERB_VINKUA	nkua stem, nku : ngu variatoins
VERB_VIPAJAA	ajaa stem, defective inflection
VERB_VIRKKAA	kkaa stem, kkaa : ka variation
VERB_VONGATA	gata stem, gata : kaa variation
VERB_VYYHDETÄ	detä stem, detä : teä variations
VERB_VÄHETÄ	etä stem, etä : ene varitions
VERB_VÄLPÄTÄ	pätä stem, pätä : ppää variastions
VERB_VÄNGÄTÄ	ngätä stem, gätä : kää variations
VERB_YLTÄÄ	ltää stem, ltää : llä variations
VERB_YNNÄTÄ	ätä stem, ätä : ää variations
VERB_YSKÄHTÄÄ	tää stem, tää : di variations
VERB_YÖKÄTÄ	kätä stem, kätä : kkää variastions
VERB_ÄHKÄÄ	kää stem, kää : i variatons
VERB_ÄKSYILLÄ	illä stem, illä : ile vaqiraiotns
VERB_ÄLLISTYÄ	tyä stem, no variations
VERB_ÄNGETÄ	getä stem, getä : keä variations
VERB_ÄRISTÄ	stä stem, stä : se variations
VERB_ÖYKKÄRÖIDÄ	öidä stem, öidä : öi ~ öise variations
X_51eikä	Verbal conjunction compound ‘eikä’ («‘ja+ei’, not) inflects from the first part like ‘ei’
X_51ettei	Verbal conjunction compounds of type ‘ettei’ («‘että+ei’) inflects from the end like ‘ei’
X_51äläkä	Partial inflection of imperative negation verb ‘älä’, conjunction ‘ja’ inflects from first part like ‘ei’
X_FORGN_DE	new particles of German origin, such as: der, zu; used often in proper nouns like particles
X_FORGN_EN	new particles of English origin, such as: the, and, of; used often in proper nouns like particles
X_FORGN_SV	new particles of Swedish origin; used often in proper nouns like particles
X_IGNORE	words that need to be in lexicon for legacy reasons (stability, etc.) but shall not appear in real applications
X_PREFIX_GOESWITH	some prefixes are mistakenly spelled separately, such as ‘tipo tiessään’.
X_SUFFIX_GOESWITH	some suffixes that appear mistokenised, such as ‘XXX:llä’ tokenised as XXX : llä
